AAAAACTCGATCCAATCGGT -> AAAACTCGATCCAATCGGTG
AAAACTCGATCCAATCGGTG -> AAACTCGATCCAATCGGTGT
AAAATACAGCTTCCTATAGA -> AAATACAGCTTCCTATAGAT
AAAATGCCGCTTCATTTTGA -> AAATGCCGCTTCATTTTGAA
AAACCGATACAGCTGGGACG -> AACCGATACAGCTGGGACGG
AAACGGGCTCTTGATTTCGA -> AACGGGCTCTTGATTTCGAG
AAACGTGCATAAACTATTGA -> AACGTGCATAAACTATTGAT
AAACTATTGATGTACCCAGT -> AACTATTGATGTACCCAGTC
AAACTCGATCCAATCGGTGT -> AACTCGATCCAATCGGTGTG
AAATACAGCTTCCTATAGAT -> AATACAGCTTCCTATAGATA
AAATGCCGCTTCATTTTGAA -> AATGCCGCTTCATTTTGAAC
AAATGTGCGTGTTCACTAGC -> AATGTGCGTGTTCACTAGCC
AACAACGGCGGCGCTTAGTT -> ACAACGGCGGCGCTTAGTTC
AACACTACTGGAGGAAACCG -> ACACTACTGGAGGAAACCGA
AACCAGGGTAGAACGGATAC -> ACCAGGGTAGAACGGATACA
AACCGATACAGCTGGGACGG -> ACCGATACAGCTGGGACGGA
AACCGTTTATGAGTTGCATG -> ACCGTTTATGAGTTGCATGA
AACCTGTGAATCGACTAACG -> ACCTGTGAATCGACTAACGT
AACGCGTTACGGCACTCTTA -> ACGCGTTACGGCACTCTTAA
AACGCTAAGGATTTTTGGGG -> ACGCTAAGGATTTTTGGGGC
AACGGATACATCCTACGGAG -> ACGGATACATCCTACGGAGC
AACGGCGGCGCTTAGTTCAC -> ACGGCGGCGCTTAGTTCACT
AACGGGCCGCACGTTCGGAA -> ACGGGCCGCACGTTCGGAAC
AACGGGCTCTTGATTTCGAG -> ACGGGCTCTTGATTTCGAGT
AACGTACACTATGTTGCAAC -> ACGTACACTATGTTGCAACT
AACGTACTCTGCCCAGTCAC -> ACGTACTCTGCCCAGTCACA
AACGTGCATAAACTATTGAT -> ACGTGCATAAACTATTGATG
AACTATACCTTCGCGCAGCG -> ACTATACCTTCGCGCAGCGG
AACTATTGATGTACCCAGTC -> ACTATTGATGTACCCAGTCA
AACTCGATCCAATCGGTGTG -> ACTCGATCCAATCGGTGTGC
AACTGAAATGTGCGTGTTCA -> ACTGAAATGTGCGTGTTCAC
AACTGAACTGAGAAGCTACC -> ACTGAACTGAGAAGCTACCT
AACTGAGAAGCTACCTTAGA -> ACTGAGAAGCTACCTTAGAA
AAGATATAGTCCGGCAGTCA -> AGATATAGTCCGGCAGTCAT
AAGCACGATCCAAACGTGCA -> AGCACGATCCAAACGTGCAT
AAGCCCCCCCTCAGACCTGT -> AGCCCCCCCTCAGACCTGTA
AAGCTACCTTAGAAGGTTTG -> AGCTACCTTAGAAGGTTTGT
AAGGATTAGGCGTCCGACAC -> AGGATTAGGCGTCCGACACT
AAGGATTTTTGGGGCCTCTT -> AGGATTTTTGGGGCCTCTTT
AAGGTTTGTACGCCGCAGGC -> AGGTTTGTACGCCGCAGGCG
AATACAGCTTCCTATAGATA -> ATACAGCTTCCTATAGATAA
AATCCGAATTGTGGATTGGG -> ATCCGAATTGTGGATTGGGA
AATCGACTAACGTACTCTGC -> ATCGACTAACGTACTCTGCC
AATCGGTGTGCGACCTGTCA -> ATCGGTGTGCGACCTGTCAG
AATGCCGCTTCATTTTGAAC -> ATGCCGCTTCATTTTGAACC
AATGGCTGCATCTTGGCACT -> ATGGCTGCATCTTGGCACTG
AATGTGCGTGTTCACTAGCC -> ATGTGCGTGTTCACTAGCCA
AATTGTGGATTGGGAGATGG -> ATTGTGGATTGGGAGATGGA
AATTTGGACCTCCCTCGGTG -> ATTTGGACCTCCCTCGGTGC
ACAACGGCGGCGCTTAGTTC -> CAACGGCGGCGCTTAGTTCA
ACAACTGAACTGAGAAGCTA -> CAACTGAACTGAGAAGCTAC
ACAAGCCCCCCCTCAGACCT -> CAAGCCCCCCCTCAGACCTG
ACACACTTTAGAGCCGTCCG -> CACACTTTAGAGCCGTCCGG
ACACCCTATGTATGCATGGA -> CACCCTATGTATGCATGGAT
ACACTACTGGAGGAAACCGA -> CACTACTGGAGGAAACCGAT
ACACTATGTTGCAACTATAC -> CACTATGTTGCAACTATACC
ACACTCACTTCTGCGTCTAA -> CACTCACTTCTGCGTCTAAC
ACACTTTAGAGCCGTCCGGA -> CACTTTAGAGCCGTCCGGAA
ACAGCTGGGACGGAACGGGC -> CAGCTGGGACGGAACGGGCC
ACAGCTTCCTATAGATAAGC -> CAGCTTCCTATAGATAAGCA
ACATCCTACGGAGCGCTCCG -> CATCCTACGGAGCGCTCCGG
ACCAGGGTAGAACGGATACA -> CCAGGGTAGAACGGATACAT
ACCCAGCTCAGCCACTAGTT -> CCCAGCTCAGCCACTAGTTC
ACCCAGTCACTCGTCACGGC -> CCCAGTCACTCGTCACGGCC
ACCCTATGTATGCATGGATG -> CCCTATGTATGCATGGATGC
ACCGATACAGCTGGGACGGA -> CCGATACAGCTGGGACGGAA
ACCGCAATGGCTGCATCTTG -> CCGCAATGGCTGCATCTTGG
ACCGTTTATGAGTTGCATGA -> CCGTTTATGAGTTGCATGAG
ACCTCCCTCGGTGCAAAATG -> CCTCCCTCGGTGCAAAATGC
ACCTCCTGGGAGCTCCTTAT -> CCTCCTGGGAGCTCCTTATA
ACCTGGGGTACCCAGCTCAG -> CCTGGGGTACCCAGCTCAGC
ACCTGGTCCTCGCCATCCGT -> CCTGGTCCTCGCCATCCGTT
ACCTGTAGTAGGACGACGTG -> CCTGTAGTAGGACGACGTGT
ACCTGTCAGAATCCGAATTG -> CCTGTCAGAATCCGAATTGT
ACCTGTGAATCGACTAACGT -> CCTGTGAATCGACTAACGTA
ACCTTAGAAGGTTTGTACGC -> CCTTAGAAGGTTTGTACGCC
ACCTTCGCGCAGCGGGACTC -> CCTTCGCGCAGCGGGACTCT
ACGACGTGTCTGGTGCATAC -> CGACGTGTCTGGTGCATACA
ACGATCCAAACGTGCATAAA -> CGATCCAAACGTGCATAAAC
ACGCCGCAGGCGTCCGACTT -> CGCCGCAGGCGTCCGACTTG
ACGCGTTACGGCACTCTTAA -> CGCGTTACGGCACTCTTAAA
ACGCTAAGGATTTTTGGGGC -> CGCTAAGGATTTTTGGGGCC
ACGGAACGGGCCGCACGTTC -> CGGAACGGGCCGCACGTTCG
ACGGAGCGCTCCGGCGATTA -> CGGAGCGCTCCGGCGATTAA
ACGGATACATCCTACGGAGC -> CGGATACATCCTACGGAGCG
ACGGCACTCTTAAAATACAG -> CGGCACTCTTAAAATACAGC
ACGGCCCGCCAATTTGGACC -> CGGCCCGCCAATTTGGACCT
ACGGCGGCGCTTAGTTCACT -> CGGCGGCGCTTAGTTCACTG
ACGGGCCGCACGTTCGGAAC -> CGGGCCGCACGTTCGGAACC
ACGGGCTCTTGATTTCGAGT -> CGGGCTCTTGATTTCGAGTG
ACGTACACTATGTTGCAACT -> CGTACACTATGTTGCAACTA
ACGTACTCTGCCCAGTCACA -> CGTACTCTGCCCAGTCACAA
ACGTGACTGCCATTTTTTTG -> CGTGACTGCCATTTTTTTGC
ACGTGCATAAACTATTGATG -> CGTGCATAAACTATTGATGT
ACGTGTCTGGTGCATACACC -> CGTGTCTGGTGCATACACCC
ACGTTCGGAACCGTTTATGA -> CGTTCGGAACCGTTTATGAG
ACTAACGTACTCTGCCCAGT -> CTAACGTACTCTGCCCAGTC
ACTACTGGAGGAAACCGATA -> CTACTGGAGGAAACCGATAC
ACTAGCCACCTCCTGGGAGC -> CTAGCCACCTCCTGGGAGCT
ACTAGTTCGGTCCACTGGCG -> CTAGTTCGGTCCACTGGCGG
ACTATAACGCGTTACGGCAC -> CTATAACGCGTTACGGCACT
ACTATACCTTCGCGCAGCGG -> CTATACCTTCGCGCAGCGGG
ACTATGTTGCAACTATACCT -> CTATGTTGCAACTATACCTT
ACTATTGATGTACCCAGTCA -> CTATTGATGTACCCAGTCAC
ACTCACTTCTGCGTCTAACA -> CTCACTTCTGCGTCTAACAA
ACTCGATCCAATCGGTGTGC -> CTCGATCCAATCGGTGTGCG
ACTCGTCACGGCCCGCCAAT -> CTCGTCACGGCCCGCCAATT
ACTCTGCCCAGTCACAAGCC -> CTCTGCCCAGTCACAAGCCC
ACTCTTAAAATACAGCTTCC -> CTCTTAAAATACAGCTTCCT
ACTCTTCTCCCCGCAGTTCG -> CTCTTCTCCCCGCAGTTCGA
ACTGAAATGTGCGTGTTCAC -> CTGAAATGTGCGTGTTCACT
ACTGAACTGAGAAGCTACCT -> CTGAACTGAGAAGCTACCTT
ACTGAGAAGCTACCTTAGAA -> CTGAGAAGCTACCTTAGAAG
ACTGCCATTTTTTTGCCGAT -> CTGCCATTTTTTTGCCGATA
ACTGGAGGAAACCGATACAG -> CTGGAGGAAACCGATACAGC
ACTGGCGGAAACGGGCTCTT -> CTGGCGGAAACGGGCTCTTG
ACTGGCGGGTTAGGCCCGTA -> CTGGCGGGTTAGGCCCGTAG
ACTGGTAGAAGATATAGTCC -> CTGGTAGAAGATATAGTCCG
ACTGTAACGCTAAGGATTTT -> CTGTAACGCTAAGGATTTTT
ACTTCTGCGTCTAACAACGG -> CTTCTGCGTCTAACAACGGC
ACTTGGGCAAGGATTAGGCG -> CTTGGGCAAGGATTAGGCGT
ACTTTAGAGCCGTCCGGAAC -> CTTTAGAGCCGTCCGGAACG
ACTTTCCCCAGTTCGATTCG -> CTTTCCCCAGTTCGATTCGT
AGAACGGATACATCCTACGG -> GAACGGATACATCCTACGGA
AGAAGATATAGTCCGGCAGT -> GAAGATATAGTCCGGCAGTC
AGAAGCTACCTTAGAAGGTT -> GAAGCTACCTTAGAAGGTTT
AGAAGGTTTGTACGCCGCAG -> GAAGGTTTGTACGCCGCAGG
AGAATCCGAATTGTGGATTG -> GAATCCGAATTGTGGATTGG
AGACCTGGGGTACCCAGCTC -> GACCTGGGGTACCCAGCTCA
AGACCTGTAGTAGGACGACG -> GACCTGTAGTAGGACGACGT
AGAGCCGTCCGGAACGTACA -> GAGCCGTCCGGAACGTACAC
AGATAAGCACGATCCAAACG -> GATAAGCACGATCCAAACGT
AGATATAGTCCGGCAGTCAT -> GATATAGTCCGGCAGTCATG
AGATGAGGTTCCTATCGACA -> GATGAGGTTCCTATCGACAA
AGATGGATAACACTACTGGA -> GATGGATAACACTACTGGAG
AGCAAAAACTCGATCCAATC -> GCAAAAACTCGATCCAATCG
AGCACGATCCAAACGTGCAT -> GCACGATCCAAACGTGCATA
AGCCACCTCCTGGGAGCTCC -> GCCACCTCCTGGGAGCTCCT
AGCCACTAGTTCGGTCCACT -> GCCACTAGTTCGGTCCACTG
AGCCCCCCCTCAGACCTGTA -> GCCCCCCCTCAGACCTGTAG
AGCCGTCCGGAACGTACACT -> GCCGTCCGGAACGTACACTA
AGCGCTCCGGCGATTAACGG -> GCGCTCCGGCGATTAACGGG
AGCGGGACTCTTCTCCCCGC -> GCGGGACTCTTCTCCCCGCA
AGCTACCTTAGAAGGTTTGT -> GCTACCTTAGAAGGTTTGTA
AGCTCAGCCACTAGTTCGGT -> GCTCAGCCACTAGTTCGGTC
AGCTCCTTATAGCAAAAACT -> GCTCCTTATAGCAAAAACTC
AGCTGGGACGGAACGGGCCG -> GCTGGGACGGAACGGGCCGC
AGCTTCCTATAGATAAGCAC -> GCTTCCTATAGATAAGCACG
AGGAAACCGATACAGCTGGG -> GGAAACCGATACAGCTGGGA
AGGACGACGTGTCTGGTGCA -> GGACGACGTGTCTGGTGCAT
AGGATTAGGCGTCCGACACT -> GGATTAGGCGTCCGACACTC
AGGATTTTTGGGGCCTCTTT -> GGATTTTTGGGGCCTCTTTT
AGGCCCGTAGGTACCGCAAT -> GGCCCGTAGGTACCGCAATG
AGGCGTCCGACACTCACTTC -> GGCGTCCGACACTCACTTCT
AGGCGTCCGACTTGGGCAAG -> GGCGTCCGACTTGGGCAAGG
AGGGTAGAACGGATACATCC -> GGGTAGAACGGATACATCCT
AGGTACCGCAATGGCTGCAT -> GGTACCGCAATGGCTGCATC
AGGTTCCTATCGACAACTGA -> GGTTCCTATCGACAACTGAA
AGGTTTGTACGCCGCAGGCG -> GGTTTGTACGCCGCAGGCGT
AGTAGGACGACGTGTCTGGT -> GTAGGACGACGTGTCTGGTG
AGTCACAAGCCCCCCCTCAG -> GTCACAAGCCCCCCCTCAGA
AGTCACTCGTCACGGCCCGC -> GTCACTCGTCACGGCCCGCC
AGTCATGAACTGAAATGTGC -> GTCATGAACTGAAATGTGCG
AGTCCGGCAGTCATGAACTG -> GTCCGGCAGTCATGAACTGA
AGTGCTTTGTAACCAGGGTA -> GTGCTTTGTAACCAGGGTAG
AGTTCACTGGCGGAAACGGG -> GTTCACTGGCGGAAACGGGC
AGTTCGAGATGAGGTTCCTA -> GTTCGAGATGAGGTTCCTAT
AGTTCGATTCGTGACTGGTA -> GTTCGATTCGTGACTGGTAG
AGTTCGGTCCACTGGCGGGT -> GTTCGGTCCACTGGCGGGTT
AGTTGCATGAGACCTGGGGT -> GTTGCATGAGACCTGGGGTA
ATAAACTATTGATGTACCCA -> TAAACTATTGATGTACCCAG
ATAACACTACTGGAGGAAAC -> TAACACTACTGGAGGAAACC
ATAACGCGTTACGGCACTCT -> TAACGCGTTACGGCACTCTT
ATAAGCACGATCCAAACGTG -> TAAGCACGATCCAAACGTGC
ATACACCCTATGTATGCATG -> TACACCCTATGTATGCATGG
ATACAGCTGGGACGGAACGG -> TACAGCTGGGACGGAACGGG
ATACAGCTTCCTATAGATAA -> TACAGCTTCCTATAGATAAG
ATACATCCTACGGAGCGCTC -> TACATCCTACGGAGCGCTCC
ATACCTTCGCGCAGCGGGAC -> TACCTTCGCGCAGCGGGACT
ATACGTGACTGCCATTTTTT -> TACGTGACTGCCATTTTTTT
ATAGATAAGCACGATCCAAA -> TAGATAAGCACGATCCAAAC
ATAGCAAAAACTCGATCCAA -> TAGCAAAAACTCGATCCAAT
ATAGTCCGGCAGTCATGAAC -> TAGTCCGGCAGTCATGAACT
ATATAGTCCGGCAGTCATGA -> TATAGTCCGGCAGTCATGAA
ATATCCCGTTGACTTTCCCC -> TATCCCGTTGACTTTCCCCA
ATATTGCGGTCACACACTTT -> TATTGCGGTCACACACTTTA
ATCCAAACGTGCATAAACTA -> TCCAAACGTGCATAAACTAT
ATCCAATCGGTGTGCGACCT -> TCCAATCGGTGTGCGACCTG
ATCCCGTTGACTTTCCCCAG -> TCCCGTTGACTTTCCCCAGT
ATCCGAATTGTGGATTGGGA -> TCCGAATTGTGGATTGGGAG
ATCCGTTGCGCTTCTTTCTC -> TCCGTTGCGCTTCTTTCTCA
ATCCTACGGAGCGCTCCGGC -> TCCTACGGAGCGCTCCGGCG
ATCGACAACTGAACTGAGAA -> TCGACAACTGAACTGAGAAG
ATCGACTAACGTACTCTGCC -> TCGACTAACGTACTCTGCCC
ATCGGTGTGCGACCTGTCAG -> TCGGTGTGCGACCTGTCAGA
ATCTTGGCACTGTAACGCTA -> TCTTGGCACTGTAACGCTAA
ATGAACTGAAATGTGCGTGT -> TGAACTGAAATGTGCGTGTT
ATGAGACCTGGGGTACCCAG -> TGAGACCTGGGGTACCCAGC
ATGAGGTTCCTATCGACAAC -> TGAGGTTCCTATCGACAACT
ATGAGTTGCATGAGACCTGG -> TGAGTTGCATGAGACCTGGG
ATGCATGGATGCGCATATTG -> TGCATGGATGCGCATATTGC
ATGCCGCTTCATTTTGAACC -> TGCCGCTTCATTTTGAACCT
ATGCGCATATTGCGGTCACA -> TGCGCATATTGCGGTCACAC
ATGGATAACACTACTGGAGG -> TGGATAACACTACTGGAGGA
ATGGATGCGCATATTGCGGT -> TGGATGCGCATATTGCGGTC
ATGGCTGCATCTTGGCACTG -> TGGCTGCATCTTGGCACTGT
ATGTACCCAGTCACTCGTCA -> TGTACCCAGTCACTCGTCAC
ATGTATACGTGACTGCCATT -> TGTATACGTGACTGCCATTT
ATGTATGCATGGATGCGCAT -> TGTATGCATGGATGCGCATA
ATGTGCGTGTTCACTAGCCA -> TGTGCGTGTTCACTAGCCAC
ATGTTGCAACTATACCTTCG -> TGTTGCAACTATACCTTCGC
ATTAACGGGGCAGGGAGAAT -> TTAACGGGGCAGGGAGAATC
ATTAGGCGTCCGACACTCAC -> TTAGGCGTCCGACACTCACT
ATTCGTGACTGGTAGAAGAT -> TTCGTGACTGGTAGAAGATA
ATTGATGTACCCAGTCACTC -> TTGATGTACCCAGTCACTCG
ATTGCGGTCACACACTTTAG -> TTGCGGTCACACACTTTAGA
ATTGGGAGATGGATAACACT -> TTGGGAGATGGATAACACTA
ATTGTGGATTGGGAGATGGA -> TTGTGGATTGGGAGATGGAT
ATTTCGAGTGCTTTGTAACC -> TTTCGAGTGCTTTGTAACCA
ATTTGGACCTCCCTCGGTGC -> TTTGGACCTCCCTCGGTGCA
ATTTTGAACCTGTGAATCGA -> TTTTGAACCTGTGAATCGAC
ATTTTTGGGGCCTCTTTTAC -> TTTTTGGGGCCTCTTTTACT
ATTTTTTTGCCGATATCCCG -> TTTTTTTGCCGATATCCCGT
CAAAAACTCGATCCAATCGG -> AAAAACTCGATCCAATCGGT
CAAAATGCCGCTTCATTTTG -> AAAATGCCGCTTCATTTTGA
CAAACGTGCATAAACTATTG -> AAACGTGCATAAACTATTGA
CAACGGCGGCGCTTAGTTCA -> AACGGCGGCGCTTAGTTCAC
CAACTATACCTTCGCGCAGC -> AACTATACCTTCGCGCAGCG
CAACTGAACTGAGAAGCTAC -> AACTGAACTGAGAAGCTACC
CAAGCCCCCCCTCAGACCTG -> AAGCCCCCCCTCAGACCTGT
CAAGGATTAGGCGTCCGACA -> AAGGATTAGGCGTCCGACAC
CAATCGGTGTGCGACCTGTC -> AATCGGTGTGCGACCTGTCA
CAATGGCTGCATCTTGGCAC -> AATGGCTGCATCTTGGCACT
CAATTTGGACCTCCCTCGGT -> AATTTGGACCTCCCTCGGTG
CACAAGCCCCCCCTCAGACC -> ACAAGCCCCCCCTCAGACCT
CACACACTTTAGAGCCGTCC -> ACACACTTTAGAGCCGTCCG
CACACTTTAGAGCCGTCCGG -> ACACTTTAGAGCCGTCCGGA
CACCCTATGTATGCATGGAT -> ACCCTATGTATGCATGGATG
CACCTCCTGGGAGCTCCTTA -> ACCTCCTGGGAGCTCCTTAT
CACCTGGTCCTCGCCATCCG -> ACCTGGTCCTCGCCATCCGT
CACGATCCAAACGTGCATAA -> ACGATCCAAACGTGCATAAA
CACGGCCCGCCAATTTGGAC -> ACGGCCCGCCAATTTGGACC
CACGTTCGGAACCGTTTATG -> ACGTTCGGAACCGTTTATGA
CACTACTGGAGGAAACCGAT -> ACTACTGGAGGAAACCGATA
CACTAGCCACCTCCTGGGAG -> ACTAGCCACCTCCTGGGAGC
CACTAGTTCGGTCCACTGGC -> ACTAGTTCGGTCCACTGGCG
CACTATGTTGCAACTATACC -> ACTATGTTGCAACTATACCT
CACTCACTTCTGCGTCTAAC -> ACTCACTTCTGCGTCTAACA
CACTCGTCACGGCCCGCCAA -> ACTCGTCACGGCCCGCCAAT
CACTCTTAAAATACAGCTTC -> ACTCTTAAAATACAGCTTCC
CACTGGCGGAAACGGGCTCT -> ACTGGCGGAAACGGGCTCTT
CACTGGCGGGTTAGGCCCGT -> ACTGGCGGGTTAGGCCCGTA
CACTGTAACGCTAAGGATTT -> ACTGTAACGCTAAGGATTTT
CACTTCTGCGTCTAACAACG -> ACTTCTGCGTCTAACAACGG
CACTTTAGAGCCGTCCGGAA -> ACTTTAGAGCCGTCCGGAAC
CAGAATCCGAATTGTGGATT -> AGAATCCGAATTGTGGATTG
CAGACCTGTAGTAGGACGAC -> AGACCTGTAGTAGGACGACG
CAGCCACTAGTTCGGTCCAC -> AGCCACTAGTTCGGTCCACT
CAGCGGGACTCTTCTCCCCG -> AGCGGGACTCTTCTCCCCGC
CAGCTCAGCCACTAGTTCGG -> AGCTCAGCCACTAGTTCGGT
CAGCTGGGACGGAACGGGCC -> AGCTGGGACGGAACGGGCCG
CAGCTTCCTATAGATAAGCA -> AGCTTCCTATAGATAAGCAC
CAGGCGTCCGACTTGGGCAA -> AGGCGTCCGACTTGGGCAAG
CAGGGTAGAACGGATACATC -> AGGGTAGAACGGATACATCC
CAGTCACAAGCCCCCCCTCA -> AGTCACAAGCCCCCCCTCAG
CAGTCACTCGTCACGGCCCG -> AGTCACTCGTCACGGCCCGC
CAGTCATGAACTGAAATGTG -> AGTCATGAACTGAAATGTGC
CAGTTCGAGATGAGGTTCCT -> AGTTCGAGATGAGGTTCCTA
CAGTTCGATTCGTGACTGGT -> AGTTCGATTCGTGACTGGTA
CATAAACTATTGATGTACCC -> ATAAACTATTGATGTACCCA
CATACACCCTATGTATGCAT -> ATACACCCTATGTATGCATG
CATATTGCGGTCACACACTT -> ATATTGCGGTCACACACTTT
CATCCGTTGCGCTTCTTTCT -> ATCCGTTGCGCTTCTTTCTC
CATCCTACGGAGCGCTCCGG -> ATCCTACGGAGCGCTCCGGC
CATCTTGGCACTGTAACGCT -> ATCTTGGCACTGTAACGCTA
CATGAACTGAAATGTGCGTG -> ATGAACTGAAATGTGCGTGT
CATGAGACCTGGGGTACCCA -> ATGAGACCTGGGGTACCCAG
CATGGATGCGCATATTGCGG -> ATGGATGCGCATATTGCGGT
CATGTATACGTGACTGCCAT -> ATGTATACGTGACTGCCATT
CATTTTGAACCTGTGAATCG -> ATTTTGAACCTGTGAATCGA
CATTTTTTTGCCGATATCCC -> ATTTTTTTGCCGATATCCCG
CCAAACGTGCATAAACTATT -> CAAACGTGCATAAACTATTG
CCAATCGGTGTGCGACCTGT -> CAATCGGTGTGCGACCTGTC
CCAATTTGGACCTCCCTCGG -> CAATTTGGACCTCCCTCGGT
CCACCTCCTGGGAGCTCCTT -> CACCTCCTGGGAGCTCCTTA
CCACCTGGTCCTCGCCATCC -> CACCTGGTCCTCGCCATCCG
CCACTAGTTCGGTCCACTGG -> CACTAGTTCGGTCCACTGGC
CCACTGGCGGGTTAGGCCCG -> CACTGGCGGGTTAGGCCCGT
CCAGCTCAGCCACTAGTTCG -> CAGCTCAGCCACTAGTTCGG
CCAGGGTAGAACGGATACAT -> CAGGGTAGAACGGATACATC
CCAGTCACAAGCCCCCCCTC -> CAGTCACAAGCCCCCCCTCA
CCAGTCACTCGTCACGGCCC -> CAGTCACTCGTCACGGCCCG
CCAGTTCGATTCGTGACTGG -> CAGTTCGATTCGTGACTGGT
CCATCCGTTGCGCTTCTTTC -> CATCCGTTGCGCTTCTTTCT
CCATTTTTTTGCCGATATCC -> CATTTTTTTGCCGATATCCC
CCCACCTGGTCCTCGCCATC -> CCACCTGGTCCTCGCCATCC
CCCAGCTCAGCCACTAGTTC -> CCAGCTCAGCCACTAGTTCG
CCCAGTCACAAGCCCCCCCT -> CCAGTCACAAGCCCCCCCTC
CCCAGTCACTCGTCACGGCC -> CCAGTCACTCGTCACGGCCC
CCCAGTTCGATTCGTGACTG -> CCAGTTCGATTCGTGACTGG
CCCCAGTTCGATTCGTGACT -> CCCAGTTCGATTCGTGACTG
CCCCCCCTCAGACCTGTAGT -> CCCCCCTCAGACCTGTAGTA
CCCCCCTCAGACCTGTAGTA -> CCCCCTCAGACCTGTAGTAG
CCCCCTCAGACCTGTAGTAG -> CCCCTCAGACCTGTAGTAGG
CCCCGCAGTTCGAGATGAGG -> CCCGCAGTTCGAGATGAGGT
CCCCTCAGACCTGTAGTAGG -> CCCTCAGACCTGTAGTAGGA
CCCGCAGTTCGAGATGAGGT -> CCGCAGTTCGAGATGAGGTT
CCCGCCAATTTGGACCTCCC -> CCGCCAATTTGGACCTCCCT
CCCGTAGGTACCGCAATGGC -> CCGTAGGTACCGCAATGGCT
CCCGTTGACTTTCCCCAGTT -> CCGTTGACTTTCCCCAGTTC
CCCTATGTATGCATGGATGC -> CCTATGTATGCATGGATGCG
CCCTCAGACCTGTAGTAGGA -> CCTCAGACCTGTAGTAGGAC
CCCTCGGTGCAAAATGCCGC -> CCTCGGTGCAAAATGCCGCT
CCGAATTGTGGATTGGGAGA -> CGAATTGTGGATTGGGAGAT
CCGACACTCACTTCTGCGTC -> CGACACTCACTTCTGCGTCT
CCGACTTGGGCAAGGATTAG -> CGACTTGGGCAAGGATTAGG
CCGATACAGCTGGGACGGAA -> CGATACAGCTGGGACGGAAC
CCGATATCCCGTTGACTTTC -> CGATATCCCGTTGACTTTCC
CCGCAATGGCTGCATCTTGG -> CGCAATGGCTGCATCTTGGC
CCGCACGTTCGGAACCGTTT -> CGCACGTTCGGAACCGTTTA
CCGCAGGCGTCCGACTTGGG -> CGCAGGCGTCCGACTTGGGC
CCGCAGTTCGAGATGAGGTT -> CGCAGTTCGAGATGAGGTTC
CCGCCAATTTGGACCTCCCT -> CGCCAATTTGGACCTCCCTC
CCGCTTCATTTTGAACCTGT -> CGCTTCATTTTGAACCTGTG
CCGGAACGTACACTATGTTG -> CGGAACGTACACTATGTTGC
CCGGCAGTCATGAACTGAAA -> CGGCAGTCATGAACTGAAAT
CCGGCGATTAACGGGGCAGG -> CGGCGATTAACGGGGCAGGG
CCGTAGGTACCGCAATGGCT -> CGTAGGTACCGCAATGGCTG
CCGTCCGGAACGTACACTAT -> CGTCCGGAACGTACACTATG
CCGTTGACTTTCCCCAGTTC -> CGTTGACTTTCCCCAGTTCG
CCGTTGCGCTTCTTTCTCAT -> CGTTGCGCTTCTTTCTCATG
CCGTTTATGAGTTGCATGAG -> CGTTTATGAGTTGCATGAGA
CCTACGGAGCGCTCCGGCGA -> CTACGGAGCGCTCCGGCGAT
CCTATAGATAAGCACGATCC -> CTATAGATAAGCACGATCCA
CCTATCGACAACTGAACTGA -> CTATCGACAACTGAACTGAG
CCTATGTATGCATGGATGCG -> CTATGTATGCATGGATGCGC
CCTCAGACCTGTAGTAGGAC -> CTCAGACCTGTAGTAGGACG
CCTCCCTCGGTGCAAAATGC -> CTCCCTCGGTGCAAAATGCC
CCTCCTGGGAGCTCCTTATA -> CTCCTGGGAGCTCCTTATAG
CCTCGCCATCCGTTGCGCTT -> CTCGCCATCCGTTGCGCTTC
CCTCGGTGCAAAATGCCGCT -> CTCGGTGCAAAATGCCGCTT
CCTCTTTTACTATAACGCGT -> CTCTTTTACTATAACGCGTT
CCTGGGAGCTCCTTATAGCA -> CTGGGAGCTCCTTATAGCAA
CCTGGGGTACCCAGCTCAGC -> CTGGGGTACCCAGCTCAGCC
CCTGGTCCTCGCCATCCGTT -> CTGGTCCTCGCCATCCGTTG
CCTGTAGTAGGACGACGTGT -> CTGTAGTAGGACGACGTGTC
CCTGTCAGAATCCGAATTGT -> CTGTCAGAATCCGAATTGTG
CCTGTGAATCGACTAACGTA -> CTGTGAATCGACTAACGTAC
CCTTAGAAGGTTTGTACGCC -> CTTAGAAGGTTTGTACGCCG
CCTTATAGCAAAAACTCGAT -> CTTATAGCAAAAACTCGATC
CCTTCGCGCAGCGGGACTCT -> CTTCGCGCAGCGGGACTCTT
CGAATTGTGGATTGGGAGAT -> GAATTGTGGATTGGGAGATG
CGACAACTGAACTGAGAAGC -> GACAACTGAACTGAGAAGCT
CGACACTCACTTCTGCGTCT -> GACACTCACTTCTGCGTCTA
CGACCTGTCAGAATCCGAAT -> GACCTGTCAGAATCCGAATT
CGACGTGTCTGGTGCATACA -> GACGTGTCTGGTGCATACAC
CGACTAACGTACTCTGCCCA -> GACTAACGTACTCTGCCCAG
CGACTTGGGCAAGGATTAGG -> GACTTGGGCAAGGATTAGGC
CGAGATGAGGTTCCTATCGA -> GAGATGAGGTTCCTATCGAC
CGAGTGCTTTGTAACCAGGG -> GAGTGCTTTGTAACCAGGGT
CGATACAGCTGGGACGGAAC -> GATACAGCTGGGACGGAACG
CGATATCCCGTTGACTTTCC -> GATATCCCGTTGACTTTCCC
CGATCCAAACGTGCATAAAC -> GATCCAAACGTGCATAAACT
CGATCCAATCGGTGTGCGAC -> GATCCAATCGGTGTGCGACC
CGATTAACGGGGCAGGGAGA -> GATTAACGGGGCAGGGAGAA
CGATTCGTGACTGGTAGAAG -> GATTCGTGACTGGTAGAAGA
CGCAATGGCTGCATCTTGGC -> GCAATGGCTGCATCTTGGCA
CGCACGTTCGGAACCGTTTA -> GCACGTTCGGAACCGTTTAT
CGCAGCGGGACTCTTCTCCC -> GCAGCGGGACTCTTCTCCCC
CGCAGGCGTCCGACTTGGGC -> GCAGGCGTCCGACTTGGGCA
CGCAGTTCGAGATGAGGTTC -> GCAGTTCGAGATGAGGTTCC
CGCATATTGCGGTCACACAC -> GCATATTGCGGTCACACACT
CGCCAATTTGGACCTCCCTC -> GCCAATTTGGACCTCCCTCG
CGCCATCCGTTGCGCTTCTT -> GCCATCCGTTGCGCTTCTTT
CGCCGCAGGCGTCCGACTTG -> GCCGCAGGCGTCCGACTTGG
CGCGCAGCGGGACTCTTCTC -> GCGCAGCGGGACTCTTCTCC
CGCGTTACGGCACTCTTAAA -> GCGTTACGGCACTCTTAAAA
CGCTAAGGATTTTTGGGGCC -> GCTAAGGATTTTTGGGGCCT
CGCTCCGGCGATTAACGGGG -> GCTCCGGCGATTAACGGGGC
CGCTTAGTTCACTGGCGGAA -> GCTTAGTTCACTGGCGGAAA
CGCTTCATTTTGAACCTGTG -> GCTTCATTTTGAACCTGTGA
CGCTTCTTTCTCATGTATAC -> GCTTCTTTCTCATGTATACG
CGGAAACGGGCTCTTGATTT -> GGAAACGGGCTCTTGATTTC
CGGAACCGTTTATGAGTTGC -> GGAACCGTTTATGAGTTGCA
CGGAACGGGCCGCACGTTCG -> GGAACGGGCCGCACGTTCGG
CGGAACGTACACTATGTTGC -> GGAACGTACACTATGTTGCA
CGGAGCGCTCCGGCGATTAA -> GGAGCGCTCCGGCGATTAAC
CGGATACATCCTACGGAGCG -> GGATACATCCTACGGAGCGC
CGGCACTCTTAAAATACAGC -> GGCACTCTTAAAATACAGCT
CGGCAGTCATGAACTGAAAT -> GGCAGTCATGAACTGAAATG
CGGCCCGCCAATTTGGACCT -> GGCCCGCCAATTTGGACCTC
CGGCGATTAACGGGGCAGGG -> GGCGATTAACGGGGCAGGGA
CGGCGCTTAGTTCACTGGCG -> GGCGCTTAGTTCACTGGCGG
CGGCGGCGCTTAGTTCACTG -> GGCGGCGCTTAGTTCACTGG
CGGGACTCTTCTCCCCGCAG -> GGGACTCTTCTCCCCGCAGT
CGGGCCGCACGTTCGGAACC -> GGGCCGCACGTTCGGAACCG
CGGGCTCTTGATTTCGAGTG -> GGGCTCTTGATTTCGAGTGC
CGGGTTAGGCCCGTAGGTAC -> GGGTTAGGCCCGTAGGTACC
CGGTCACACACTTTAGAGCC -> GGTCACACACTTTAGAGCCG
CGGTCCACTGGCGGGTTAGG -> GGTCCACTGGCGGGTTAGGC
CGGTGCAAAATGCCGCTTCA -> GGTGCAAAATGCCGCTTCAT
CGGTGTGCGACCTGTCAGAA -> GGTGTGCGACCTGTCAGAAT
CGTACACTATGTTGCAACTA -> GTACACTATGTTGCAACTAT
CGTACTCTGCCCAGTCACAA -> GTACTCTGCCCAGTCACAAG
CGTAGGTACCGCAATGGCTG -> GTAGGTACCGCAATGGCTGC
CGTCACGGCCCGCCAATTTG -> GTCACGGCCCGCCAATTTGG
CGTCCGACACTCACTTCTGC -> GTCCGACACTCACTTCTGCG
CGTCCGACTTGGGCAAGGAT -> GTCCGACTTGGGCAAGGATT
CGTCCGGAACGTACACTATG -> GTCCGGAACGTACACTATGT
CGTCTAACAACGGCGGCGCT -> GTCTAACAACGGCGGCGCTT
CGTGACTGCCATTTTTTTGC -> GTGACTGCCATTTTTTTGCC
CGTGACTGGTAGAAGATATA -> GTGACTGGTAGAAGATATAG
CGTGCATAAACTATTGATGT -> GTGCATAAACTATTGATGTA
CGTGTCTGGTGCATACACCC -> GTGTCTGGTGCATACACCCT
CGTGTTCACTAGCCACCTCC -> GTGTTCACTAGCCACCTCCT
CGTTACGGCACTCTTAAAAT -> GTTACGGCACTCTTAAAATA
CGTTCGGAACCGTTTATGAG -> GTTCGGAACCGTTTATGAGT
CGTTGACTTTCCCCAGTTCG -> GTTGACTTTCCCCAGTTCGA
CGTTGCGCTTCTTTCTCATG -> GTTGCGCTTCTTTCTCATGT
CGTTTATGAGTTGCATGAGA -> GTTTATGAGTTGCATGAGAC
CTAACAACGGCGGCGCTTAG -> TAACAACGGCGGCGCTTAGT
CTAACGTACTCTGCCCAGTC -> TAACGTACTCTGCCCAGTCA
CTAAGGATTTTTGGGGCCTC -> TAAGGATTTTTGGGGCCTCT
CTACCTTAGAAGGTTTGTAC -> TACCTTAGAAGGTTTGTACG
CTACGGAGCGCTCCGGCGAT -> TACGGAGCGCTCCGGCGATT
CTACTGGAGGAAACCGATAC -> TACTGGAGGAAACCGATACA
CTAGCCACCTCCTGGGAGCT -> TAGCCACCTCCTGGGAGCTC
CTAGTTCGGTCCACTGGCGG -> TAGTTCGGTCCACTGGCGGG
CTATAACGCGTTACGGCACT -> TATAACGCGTTACGGCACTC
CTATACCTTCGCGCAGCGGG -> TATACCTTCGCGCAGCGGGA
CTATAGATAAGCACGATCCA -> TATAGATAAGCACGATCCAA
CTATCGACAACTGAACTGAG -> TATCGACAACTGAACTGAGA
CTATGTATGCATGGATGCGC -> TATGTATGCATGGATGCGCA
CTATGTTGCAACTATACCTT -> TATGTTGCAACTATACCTTC
CTATTGATGTACCCAGTCAC -> TATTGATGTACCCAGTCACT
CTCACTTCTGCGTCTAACAA -> TCACTTCTGCGTCTAACAAC
CTCAGACCTGTAGTAGGACG -> TCAGACCTGTAGTAGGACGA
CTCAGCCACTAGTTCGGTCC -> TCAGCCACTAGTTCGGTCCA
CTCATGTATACGTGACTGCC -> TCATGTATACGTGACTGCCA
CTCCCCGCAGTTCGAGATGA -> TCCCCGCAGTTCGAGATGAG
CTCCCTCGGTGCAAAATGCC -> TCCCTCGGTGCAAAATGCCG
CTCCGGCGATTAACGGGGCA -> TCCGGCGATTAACGGGGCAG
CTCCTGGGAGCTCCTTATAG -> TCCTGGGAGCTCCTTATAGC
CTCCTTATAGCAAAAACTCG -> TCCTTATAGCAAAAACTCGA
CTCGATCCAATCGGTGTGCG -> TCGATCCAATCGGTGTGCGA
CTCGCCATCCGTTGCGCTTC -> TCGCCATCCGTTGCGCTTCT
CTCGGTGCAAAATGCCGCTT -> TCGGTGCAAAATGCCGCTTC
CTCGTCACGGCCCGCCAATT -> TCGTCACGGCCCGCCAATTT
CTCTGCCCAGTCACAAGCCC -> TCTGCCCAGTCACAAGCCCC
CTCTTAAAATACAGCTTCCT -> TCTTAAAATACAGCTTCCTA
CTCTTCTCCCCGCAGTTCGA -> TCTTCTCCCCGCAGTTCGAG
CTCTTGATTTCGAGTGCTTT -> TCTTGATTTCGAGTGCTTTG
CTCTTTTACTATAACGCGTT -> TCTTTTACTATAACGCGTTA
CTGAAATGTGCGTGTTCACT -> TGAAATGTGCGTGTTCACTA
CTGAACTGAGAAGCTACCTT -> TGAACTGAGAAGCTACCTTA
CTGAGAAGCTACCTTAGAAG -> TGAGAAGCTACCTTAGAAGG
CTGCATCTTGGCACTGTAAC -> TGCATCTTGGCACTGTAACG
CTGCCATTTTTTTGCCGATA -> TGCCATTTTTTTGCCGATAT
CTGCCCAGTCACAAGCCCCC -> TGCCCAGTCACAAGCCCCCC
CTGCGTCTAACAACGGCGGC -> TGCGTCTAACAACGGCGGCG
CTGGAGGAAACCGATACAGC -> TGGAGGAAACCGATACAGCT
CTGGCGGAAACGGGCTCTTG -> TGGCGGAAACGGGCTCTTGA
CTGGCGGGTTAGGCCCGTAG -> TGGCGGGTTAGGCCCGTAGG
CTGGGACGGAACGGGCCGCA -> TGGGACGGAACGGGCCGCAC
CTGGGAGCTCCTTATAGCAA -> TGGGAGCTCCTTATAGCAAA
CTGGGGTACCCAGCTCAGCC -> TGGGGTACCCAGCTCAGCCA
CTGGTAGAAGATATAGTCCG -> TGGTAGAAGATATAGTCCGG
CTGGTCCTCGCCATCCGTTG -> TGGTCCTCGCCATCCGTTGC
CTGGTGCATACACCCTATGT -> TGGTGCATACACCCTATGTA
CTGTAACGCTAAGGATTTTT -> TGTAACGCTAAGGATTTTTG
CTGTAGTAGGACGACGTGTC -> TGTAGTAGGACGACGTGTCT
CTGTCAGAATCCGAATTGTG -> TGTCAGAATCCGAATTGTGG
CTGTGAATCGACTAACGTAC -> TGTGAATCGACTAACGTACT
CTTAAAATACAGCTTCCTAT -> TTAAAATACAGCTTCCTATA
CTTAGAAGGTTTGTACGCCG -> TTAGAAGGTTTGTACGCCGC
CTTAGTTCACTGGCGGAAAC -> TTAGTTCACTGGCGGAAACG
CTTATAGCAAAAACTCGATC -> TTATAGCAAAAACTCGATCC
CTTCATTTTGAACCTGTGAA -> TTCATTTTGAACCTGTGAAT
CTTCCTATAGATAAGCACGA -> TTCCTATAGATAAGCACGAT
CTTCGCGCAGCGGGACTCTT -> TTCGCGCAGCGGGACTCTTC
CTTCTCCCCGCAGTTCGAGA -> TTCTCCCCGCAGTTCGAGAT
CTTCTGCGTCTAACAACGGC -> TTCTGCGTCTAACAACGGCG
CTTCTTTCTCATGTATACGT -> TTCTTTCTCATGTATACGTG
CTTGATTTCGAGTGCTTTGT -> TTGATTTCGAGTGCTTTGTA
CTTGGCACTGTAACGCTAAG -> TTGGCACTGTAACGCTAAGG
CTTGGGCAAGGATTAGGCGT -> TTGGGCAAGGATTAGGCGTC
CTTTAGAGCCGTCCGGAACG -> TTTAGAGCCGTCCGGAACGT
CTTTCCCCAGTTCGATTCGT -> TTTCCCCAGTTCGATTCGTG
CTTTCTCATGTATACGTGAC -> TTTCTCATGTATACGTGACT
CTTTGTAACCAGGGTAGAAC -> TTTGTAACCAGGGTAGAACG
CTTTTACTATAACGCGTTAC -> TTTTACTATAACGCGTTACG
GAAACCGATACAGCTGGGAC -> AAACCGATACAGCTGGGACG
GAAACGGGCTCTTGATTTCG -> AAACGGGCTCTTGATTTCGA
GAAATGTGCGTGTTCACTAG -> AAATGTGCGTGTTCACTAGC
GAACCGTTTATGAGTTGCAT -> AACCGTTTATGAGTTGCATG
GAACCTGTGAATCGACTAAC -> AACCTGTGAATCGACTAACG
GAACGGATACATCCTACGGA -> AACGGATACATCCTACGGAG
GAACGGGCCGCACGTTCGGA -> AACGGGCCGCACGTTCGGAA
GAACGTACACTATGTTGCAA -> AACGTACACTATGTTGCAAC
GAACTGAAATGTGCGTGTTC -> AACTGAAATGTGCGTGTTCA
GAACTGAGAAGCTACCTTAG -> AACTGAGAAGCTACCTTAGA
GAAGATATAGTCCGGCAGTC -> AAGATATAGTCCGGCAGTCA
GAAGCTACCTTAGAAGGTTT -> AAGCTACCTTAGAAGGTTTG
GAAGGTTTGTACGCCGCAGG -> AAGGTTTGTACGCCGCAGGC
GAATCCGAATTGTGGATTGG -> AATCCGAATTGTGGATTGGG
GAATCGACTAACGTACTCTG -> AATCGACTAACGTACTCTGC
GAATTGTGGATTGGGAGATG -> AATTGTGGATTGGGAGATGG
GACAACTGAACTGAGAAGCT -> ACAACTGAACTGAGAAGCTA
GACACTCACTTCTGCGTCTA -> ACACTCACTTCTGCGTCTAA
GACCTCCCTCGGTGCAAAAT -> ACCTCCCTCGGTGCAAAATG
GACCTGGGGTACCCAGCTCA -> ACCTGGGGTACCCAGCTCAG
GACCTGTAGTAGGACGACGT -> ACCTGTAGTAGGACGACGTG
GACCTGTCAGAATCCGAATT -> ACCTGTCAGAATCCGAATTG
GACGACGTGTCTGGTGCATA -> ACGACGTGTCTGGTGCATAC
GACGGAACGGGCCGCACGTT -> ACGGAACGGGCCGCACGTTC
GACGTGTCTGGTGCATACAC -> ACGTGTCTGGTGCATACACC
GACTAACGTACTCTGCCCAG -> ACTAACGTACTCTGCCCAGT
GACTCTTCTCCCCGCAGTTC -> ACTCTTCTCCCCGCAGTTCG
GACTGCCATTTTTTTGCCGA -> ACTGCCATTTTTTTGCCGAT
GACTGGTAGAAGATATAGTC -> ACTGGTAGAAGATATAGTCC
GACTTGGGCAAGGATTAGGC -> ACTTGGGCAAGGATTAGGCG
GACTTTCCCCAGTTCGATTC -> ACTTTCCCCAGTTCGATTCG
GAGAAGCTACCTTAGAAGGT -> AGAAGCTACCTTAGAAGGTT
GAGACCTGGGGTACCCAGCT -> AGACCTGGGGTACCCAGCTC
GAGATGAGGTTCCTATCGAC -> AGATGAGGTTCCTATCGACA
GAGATGGATAACACTACTGG -> AGATGGATAACACTACTGGA
GAGCCGTCCGGAACGTACAC -> AGCCGTCCGGAACGTACACT
GAGCGCTCCGGCGATTAACG -> AGCGCTCCGGCGATTAACGG
GAGCTCCTTATAGCAAAAAC -> AGCTCCTTATAGCAAAAACT
GAGGAAACCGATACAGCTGG -> AGGAAACCGATACAGCTGGG
GAGGTTCCTATCGACAACTG -> AGGTTCCTATCGACAACTGA
GAGTGCTTTGTAACCAGGGT -> AGTGCTTTGTAACCAGGGTA
GAGTTGCATGAGACCTGGGG -> AGTTGCATGAGACCTGGGGT
GATAACACTACTGGAGGAAA -> ATAACACTACTGGAGGAAAC
GATAAGCACGATCCAAACGT -> ATAAGCACGATCCAAACGTG
GATACAGCTGGGACGGAACG -> ATACAGCTGGGACGGAACGG
GATACATCCTACGGAGCGCT -> ATACATCCTACGGAGCGCTC
GATATAGTCCGGCAGTCATG -> ATATAGTCCGGCAGTCATGA
GATATCCCGTTGACTTTCCC -> ATATCCCGTTGACTTTCCCC
GATCCAAACGTGCATAAACT -> ATCCAAACGTGCATAAACTA
GATCCAATCGGTGTGCGACC -> ATCCAATCGGTGTGCGACCT
GATGAGGTTCCTATCGACAA -> ATGAGGTTCCTATCGACAAC
GATGCGCATATTGCGGTCAC -> ATGCGCATATTGCGGTCACA
GATGGATAACACTACTGGAG -> ATGGATAACACTACTGGAGG
GATGTACCCAGTCACTCGTC -> ATGTACCCAGTCACTCGTCA
GATTAACGGGGCAGGGAGAA -> ATTAACGGGGCAGGGAGAAT
GATTAGGCGTCCGACACTCA -> ATTAGGCGTCCGACACTCAC
GATTCGTGACTGGTAGAAGA -> ATTCGTGACTGGTAGAAGAT
GATTGGGAGATGGATAACAC -> ATTGGGAGATGGATAACACT
GATTTCGAGTGCTTTGTAAC -> ATTTCGAGTGCTTTGTAACC
GATTTTTGGGGCCTCTTTTA -> ATTTTTGGGGCCTCTTTTAC
GCAAAAACTCGATCCAATCG -> CAAAAACTCGATCCAATCGG
GCAAAATGCCGCTTCATTTT -> CAAAATGCCGCTTCATTTTG
GCAACTATACCTTCGCGCAG -> CAACTATACCTTCGCGCAGC
GCAAGGATTAGGCGTCCGAC -> CAAGGATTAGGCGTCCGACA
GCAATGGCTGCATCTTGGCA -> CAATGGCTGCATCTTGGCAC
GCACGATCCAAACGTGCATA -> CACGATCCAAACGTGCATAA
GCACGTTCGGAACCGTTTAT -> CACGTTCGGAACCGTTTATG
GCACTCTTAAAATACAGCTT -> CACTCTTAAAATACAGCTTC
GCACTGTAACGCTAAGGATT -> CACTGTAACGCTAAGGATTT
GCAGCGGGACTCTTCTCCCC -> CAGCGGGACTCTTCTCCCCG
GCAGGCGTCCGACTTGGGCA -> CAGGCGTCCGACTTGGGCAA
GCAGTCATGAACTGAAATGT -> CAGTCATGAACTGAAATGTG
GCAGTTCGAGATGAGGTTCC -> CAGTTCGAGATGAGGTTCCT
GCATAAACTATTGATGTACC -> CATAAACTATTGATGTACCC
GCATACACCCTATGTATGCA -> CATACACCCTATGTATGCAT
GCATATTGCGGTCACACACT -> CATATTGCGGTCACACACTT
GCATCTTGGCACTGTAACGC -> CATCTTGGCACTGTAACGCT
GCATGAGACCTGGGGTACCC -> CATGAGACCTGGGGTACCCA
GCATGGATGCGCATATTGCG -> CATGGATGCGCATATTGCGG
GCCAATTTGGACCTCCCTCG -> CCAATTTGGACCTCCCTCGG
GCCACCTCCTGGGAGCTCCT -> CCACCTCCTGGGAGCTCCTT
GCCACTAGTTCGGTCCACTG -> CCACTAGTTCGGTCCACTGG
GCCATCCGTTGCGCTTCTTT -> CCATCCGTTGCGCTTCTTTC
GCCATTTTTTTGCCGATATC -> CCATTTTTTTGCCGATATCC
GCCCAGTCACAAGCCCCCCC -> CCCAGTCACAAGCCCCCCCT
GCCCCCCCTCAGACCTGTAG -> CCCCCCCTCAGACCTGTAGT
GCCCGCCAATTTGGACCTCC -> CCCGCCAATTTGGACCTCCC
GCCCGTAGGTACCGCAATGG -> CCCGTAGGTACCGCAATGGC
GCCGATATCCCGTTGACTTT -> CCGATATCCCGTTGACTTTC
GCCGCACGTTCGGAACCGTT -> CCGCACGTTCGGAACCGTTT
GCCGCAGGCGTCCGACTTGG -> CCGCAGGCGTCCGACTTGGG
GCCGCTTCATTTTGAACCTG -> CCGCTTCATTTTGAACCTGT
GCCGTCCGGAACGTACACTA -> CCGTCCGGAACGTACACTAT
GCCTCTTTTACTATAACGCG -> CCTCTTTTACTATAACGCGT
GCGACCTGTCAGAATCCGAA -> CGACCTGTCAGAATCCGAAT
GCGATTAACGGGGCAGGGAG -> CGATTAACGGGGCAGGGAGA
GCGCAGCGGGACTCTTCTCC -> CGCAGCGGGACTCTTCTCCC
GCGCATATTGCGGTCACACA -> CGCATATTGCGGTCACACAC
GCGCTCCGGCGATTAACGGG -> CGCTCCGGCGATTAACGGGG
GCGCTTAGTTCACTGGCGGA -> CGCTTAGTTCACTGGCGGAA
GCGCTTCTTTCTCATGTATA -> CGCTTCTTTCTCATGTATAC
GCGGAAACGGGCTCTTGATT -> CGGAAACGGGCTCTTGATTT
GCGGCGCTTAGTTCACTGGC -> CGGCGCTTAGTTCACTGGCG
GCGGGACTCTTCTCCCCGCA -> CGGGACTCTTCTCCCCGCAG
GCGGGTTAGGCCCGTAGGTA -> CGGGTTAGGCCCGTAGGTAC
GCGGTCACACACTTTAGAGC -> CGGTCACACACTTTAGAGCC
GCGTCCGACACTCACTTCTG -> CGTCCGACACTCACTTCTGC
GCGTCCGACTTGGGCAAGGA -> CGTCCGACTTGGGCAAGGAT
GCGTCTAACAACGGCGGCGC -> CGTCTAACAACGGCGGCGCT
GCGTGTTCACTAGCCACCTC -> CGTGTTCACTAGCCACCTCC
GCGTTACGGCACTCTTAAAA -> CGTTACGGCACTCTTAAAAT
GCTAAGGATTTTTGGGGCCT -> CTAAGGATTTTTGGGGCCTC
GCTACCTTAGAAGGTTTGTA -> CTACCTTAGAAGGTTTGTAC
GCTCAGCCACTAGTTCGGTC -> CTCAGCCACTAGTTCGGTCC
GCTCCGGCGATTAACGGGGC -> CTCCGGCGATTAACGGGGCA
GCTCCTTATAGCAAAAACTC -> CTCCTTATAGCAAAAACTCG
GCTCTTGATTTCGAGTGCTT -> CTCTTGATTTCGAGTGCTTT
GCTGCATCTTGGCACTGTAA -> CTGCATCTTGGCACTGTAAC
GCTGGGACGGAACGGGCCGC -> CTGGGACGGAACGGGCCGCA
GCTTAGTTCACTGGCGGAAA -> CTTAGTTCACTGGCGGAAAC
GCTTCATTTTGAACCTGTGA -> CTTCATTTTGAACCTGTGAA
GCTTCCTATAGATAAGCACG -> CTTCCTATAGATAAGCACGA
GCTTCTTTCTCATGTATACG -> CTTCTTTCTCATGTATACGT
GCTTTGTAACCAGGGTAGAA -> CTTTGTAACCAGGGTAGAAC
GGAAACCGATACAGCTGGGA -> GAAACCGATACAGCTGGGAC
GGAAACGGGCTCTTGATTTC -> GAAACGGGCTCTTGATTTCG
GGAACCGTTTATGAGTTGCA -> GAACCGTTTATGAGTTGCAT
GGAACGGGCCGCACGTTCGG -> GAACGGGCCGCACGTTCGGA
GGAACGTACACTATGTTGCA -> GAACGTACACTATGTTGCAA
GGACCTCCCTCGGTGCAAAA -> GACCTCCCTCGGTGCAAAAT
GGACGACGTGTCTGGTGCAT -> GACGACGTGTCTGGTGCATA
GGACGGAACGGGCCGCACGT -> GACGGAACGGGCCGCACGTT
GGACTCTTCTCCCCGCAGTT -> GACTCTTCTCCCCGCAGTTC
GGAGATGGATAACACTACTG -> GAGATGGATAACACTACTGG
GGAGCGCTCCGGCGATTAAC -> GAGCGCTCCGGCGATTAACG
GGAGCTCCTTATAGCAAAAA -> GAGCTCCTTATAGCAAAAAC
GGAGGAAACCGATACAGCTG -> GAGGAAACCGATACAGCTGG
GGATAACACTACTGGAGGAA -> GATAACACTACTGGAGGAAA
GGATACATCCTACGGAGCGC -> GATACATCCTACGGAGCGCT
GGATGCGCATATTGCGGTCA -> GATGCGCATATTGCGGTCAC
GGATTAGGCGTCCGACACTC -> GATTAGGCGTCCGACACTCA
GGATTGGGAGATGGATAACA -> GATTGGGAGATGGATAACAC
GGATTTTTGGGGCCTCTTTT -> GATTTTTGGGGCCTCTTTTA
GGCAAGGATTAGGCGTCCGA -> GCAAGGATTAGGCGTCCGAC
GGCACTCTTAAAATACAGCT -> GCACTCTTAAAATACAGCTT
GGCACTGTAACGCTAAGGAT -> GCACTGTAACGCTAAGGATT
GGCAGTCATGAACTGAAATG -> GCAGTCATGAACTGAAATGT
GGCCCGCCAATTTGGACCTC -> GCCCGCCAATTTGGACCTCC
GGCCCGTAGGTACCGCAATG -> GCCCGTAGGTACCGCAATGG
GGCCGCACGTTCGGAACCGT -> GCCGCACGTTCGGAACCGTT
GGCCTCTTTTACTATAACGC -> GCCTCTTTTACTATAACGCG
GGCGATTAACGGGGCAGGGA -> GCGATTAACGGGGCAGGGAG
GGCGCTTAGTTCACTGGCGG -> GCGCTTAGTTCACTGGCGGA
GGCGGAAACGGGCTCTTGAT -> GCGGAAACGGGCTCTTGATT
GGCGGCGCTTAGTTCACTGG -> GCGGCGCTTAGTTCACTGGC
GGCGGGTTAGGCCCGTAGGT -> GCGGGTTAGGCCCGTAGGTA
GGCGTCCGACACTCACTTCT -> GCGTCCGACACTCACTTCTG
GGCGTCCGACTTGGGCAAGG -> GCGTCCGACTTGGGCAAGGA
GGCTCTTGATTTCGAGTGCT -> GCTCTTGATTTCGAGTGCTT
GGCTGCATCTTGGCACTGTA -> GCTGCATCTTGGCACTGTAA
GGGACGGAACGGGCCGCACG -> GGACGGAACGGGCCGCACGT
GGGACTCTTCTCCCCGCAGT -> GGACTCTTCTCCCCGCAGTT
GGGAGATGGATAACACTACT -> GGAGATGGATAACACTACTG
GGGAGCTCCTTATAGCAAAA -> GGAGCTCCTTATAGCAAAAA
GGGCAAGGATTAGGCGTCCG -> GGCAAGGATTAGGCGTCCGA
GGGCCGCACGTTCGGAACCG -> GGCCGCACGTTCGGAACCGT
GGGCCTCTTTTACTATAACG -> GGCCTCTTTTACTATAACGC
GGGCTCTTGATTTCGAGTGC -> GGCTCTTGATTTCGAGTGCT
GGGGCCTCTTTTACTATAAC -> GGGCCTCTTTTACTATAACG
GGGGTACCCAGCTCAGCCAC -> GGGTACCCAGCTCAGCCACT
GGGTACCCAGCTCAGCCACT -> GGTACCCAGCTCAGCCACTA
GGGTAGAACGGATACATCCT -> GGTAGAACGGATACATCCTA
GGGTTAGGCCCGTAGGTACC -> GGTTAGGCCCGTAGGTACCG
GGTACCCAGCTCAGCCACTA -> GTACCCAGCTCAGCCACTAG
GGTACCGCAATGGCTGCATC -> GTACCGCAATGGCTGCATCT
GGTAGAACGGATACATCCTA -> GTAGAACGGATACATCCTAC
GGTAGAAGATATAGTCCGGC -> GTAGAAGATATAGTCCGGCA
GGTCACACACTTTAGAGCCG -> GTCACACACTTTAGAGCCGT
GGTCCACTGGCGGGTTAGGC -> GTCCACTGGCGGGTTAGGCC
GGTCCTCGCCATCCGTTGCG -> GTCCTCGCCATCCGTTGCGC
GGTGCAAAATGCCGCTTCAT -> GTGCAAAATGCCGCTTCATT
GGTGCATACACCCTATGTAT -> GTGCATACACCCTATGTATG
GGTGTGCGACCTGTCAGAAT -> GTGTGCGACCTGTCAGAATC
GGTTAGGCCCGTAGGTACCG -> GTTAGGCCCGTAGGTACCGC
GGTTCCTATCGACAACTGAA -> GTTCCTATCGACAACTGAAC
GGTTTGTACGCCGCAGGCGT -> GTTTGTACGCCGCAGGCGTC
GTAACCAGGGTAGAACGGAT -> TAACCAGGGTAGAACGGATA
GTAACGCTAAGGATTTTTGG -> TAACGCTAAGGATTTTTGGG
GTACACTATGTTGCAACTAT -> TACACTATGTTGCAACTATA
GTACCCAGCTCAGCCACTAG -> TACCCAGCTCAGCCACTAGT
GTACCCAGTCACTCGTCACG -> TACCCAGTCACTCGTCACGG
GTACCGCAATGGCTGCATCT -> TACCGCAATGGCTGCATCTT
GTACGCCGCAGGCGTCCGAC -> TACGCCGCAGGCGTCCGACT
GTACTCTGCCCAGTCACAAG -> TACTCTGCCCAGTCACAAGC
GTAGAACGGATACATCCTAC -> TAGAACGGATACATCCTACG
GTAGAAGATATAGTCCGGCA -> TAGAAGATATAGTCCGGCAG
GTAGGACGACGTGTCTGGTG -> TAGGACGACGTGTCTGGTGC
GTAGGTACCGCAATGGCTGC -> TAGGTACCGCAATGGCTGCA
GTAGTAGGACGACGTGTCTG -> TAGTAGGACGACGTGTCTGG
GTATACGTGACTGCCATTTT -> TATACGTGACTGCCATTTTT
GTATGCATGGATGCGCATAT -> TATGCATGGATGCGCATATT
GTCACAAGCCCCCCCTCAGA -> TCACAAGCCCCCCCTCAGAC
GTCACACACTTTAGAGCCGT -> TCACACACTTTAGAGCCGTC
GTCACGGCCCGCCAATTTGG -> TCACGGCCCGCCAATTTGGA
GTCACTCGTCACGGCCCGCC -> TCACTCGTCACGGCCCGCCA
GTCAGAATCCGAATTGTGGA -> TCAGAATCCGAATTGTGGAT
GTCATGAACTGAAATGTGCG -> TCATGAACTGAAATGTGCGT
GTCCACTGGCGGGTTAGGCC -> TCCACTGGCGGGTTAGGCCC
GTCCCACCTGGTCCTCGCCA -> TCCCACCTGGTCCTCGCCAT
GTCCGACACTCACTTCTGCG -> TCCGACACTCACTTCTGCGT
GTCCGACTTGGGCAAGGATT -> TCCGACTTGGGCAAGGATTA
GTCCGGAACGTACACTATGT -> TCCGGAACGTACACTATGTT
GTCCGGCAGTCATGAACTGA -> TCCGGCAGTCATGAACTGAA
GTCCTCGCCATCCGTTGCGC -> TCCTCGCCATCCGTTGCGCT
GTCTAACAACGGCGGCGCTT -> TCTAACAACGGCGGCGCTTA
GTCTGGTGCATACACCCTAT -> TCTGGTGCATACACCCTATG
GTGAATCGACTAACGTACTC -> TGAATCGACTAACGTACTCT
GTGACTGCCATTTTTTTGCC -> TGACTGCCATTTTTTTGCCG
GTGACTGGTAGAAGATATAG -> TGACTGGTAGAAGATATAGT
GTGCAAAATGCCGCTTCATT -> TGCAAAATGCCGCTTCATTT
GTGCATAAACTATTGATGTA -> TGCATAAACTATTGATGTAC
GTGCATACACCCTATGTATG -> TGCATACACCCTATGTATGC
GTGCGACCTGTCAGAATCCG -> TGCGACCTGTCAGAATCCGA
GTGCGTGTTCACTAGCCACC -> TGCGTGTTCACTAGCCACCT
GTGCTTTGTAACCAGGGTAG -> TGCTTTGTAACCAGGGTAGA
GTGGATTGGGAGATGGATAA -> TGGATTGGGAGATGGATAAC
GTGTCTGGTGCATACACCCT -> TGTCTGGTGCATACACCCTA
GTGTGCGACCTGTCAGAATC -> TGTGCGACCTGTCAGAATCC
GTGTTCACTAGCCACCTCCT -> TGTTCACTAGCCACCTCCTG
GTTACGGCACTCTTAAAATA -> TTACGGCACTCTTAAAATAC
GTTAGGCCCGTAGGTACCGC -> TTAGGCCCGTAGGTACCGCA
GTTCACTAGCCACCTCCTGG -> TTCACTAGCCACCTCCTGGG
GTTCACTGGCGGAAACGGGC -> TTCACTGGCGGAAACGGGCT
GTTCCTATCGACAACTGAAC -> TTCCTATCGACAACTGAACT
GTTCGAGATGAGGTTCCTAT -> TTCGAGATGAGGTTCCTATC
GTTCGATTCGTGACTGGTAG -> TTCGATTCGTGACTGGTAGA
GTTCGGAACCGTTTATGAGT -> TTCGGAACCGTTTATGAGTT
GTTCGGTCCACTGGCGGGTT -> TTCGGTCCACTGGCGGGTTA
GTTGACTTTCCCCAGTTCGA -> TTGACTTTCCCCAGTTCGAT
GTTGCAACTATACCTTCGCG -> TTGCAACTATACCTTCGCGC
GTTGCATGAGACCTGGGGTA -> TTGCATGAGACCTGGGGTAC
GTTGCGCTTCTTTCTCATGT -> TTGCGCTTCTTTCTCATGTA
GTTTATGAGTTGCATGAGAC -> TTTATGAGTTGCATGAGACC
GTTTGTACGCCGCAGGCGTC -> TTTGTACGCCGCAGGCGTCC
TAAAATACAGCTTCCTATAG -> AAAATACAGCTTCCTATAGA
TAAACTATTGATGTACCCAG -> AAACTATTGATGTACCCAGT
TAACAACGGCGGCGCTTAGT -> AACAACGGCGGCGCTTAGTT
TAACACTACTGGAGGAAACC -> AACACTACTGGAGGAAACCG
TAACCAGGGTAGAACGGATA -> AACCAGGGTAGAACGGATAC
TAACGCGTTACGGCACTCTT -> AACGCGTTACGGCACTCTTA
TAACGCTAAGGATTTTTGGG -> AACGCTAAGGATTTTTGGGG
TAACGTACTCTGCCCAGTCA -> AACGTACTCTGCCCAGTCAC
TAAGCACGATCCAAACGTGC -> AAGCACGATCCAAACGTGCA
TAAGGATTTTTGGGGCCTCT -> AAGGATTTTTGGGGCCTCTT
TACACCCTATGTATGCATGG -> ACACCCTATGTATGCATGGA
TACACTATGTTGCAACTATA -> ACACTATGTTGCAACTATAC
TACAGCTGGGACGGAACGGG -> ACAGCTGGGACGGAACGGGC
TACAGCTTCCTATAGATAAG -> ACAGCTTCCTATAGATAAGC
TACATCCTACGGAGCGCTCC -> ACATCCTACGGAGCGCTCCG
TACCCAGCTCAGCCACTAGT -> ACCCAGCTCAGCCACTAGTT
TACCCAGTCACTCGTCACGG -> ACCCAGTCACTCGTCACGGC
TACCGCAATGGCTGCATCTT -> ACCGCAATGGCTGCATCTTG
TACCTTAGAAGGTTTGTACG -> ACCTTAGAAGGTTTGTACGC
TACCTTCGCGCAGCGGGACT -> ACCTTCGCGCAGCGGGACTC
TACGCCGCAGGCGTCCGACT -> ACGCCGCAGGCGTCCGACTT
TACGGAGCGCTCCGGCGATT -> ACGGAGCGCTCCGGCGATTA
TACGGCACTCTTAAAATACA -> ACGGCACTCTTAAAATACAG
TACGTGACTGCCATTTTTTT -> ACGTGACTGCCATTTTTTTG
TACTATAACGCGTTACGGCA -> ACTATAACGCGTTACGGCAC
TACTCTGCCCAGTCACAAGC -> ACTCTGCCCAGTCACAAGCC
TACTGGAGGAAACCGATACA -> ACTGGAGGAAACCGATACAG
TAGAACGGATACATCCTACG -> AGAACGGATACATCCTACGG
TAGAAGATATAGTCCGGCAG -> AGAAGATATAGTCCGGCAGT
TAGAAGGTTTGTACGCCGCA -> AGAAGGTTTGTACGCCGCAG
TAGAGCCGTCCGGAACGTAC -> AGAGCCGTCCGGAACGTACA
TAGATAAGCACGATCCAAAC -> AGATAAGCACGATCCAAACG
TAGCAAAAACTCGATCCAAT -> AGCAAAAACTCGATCCAATC
TAGCCACCTCCTGGGAGCTC -> AGCCACCTCCTGGGAGCTCC
TAGGACGACGTGTCTGGTGC -> AGGACGACGTGTCTGGTGCA
TAGGCCCGTAGGTACCGCAA -> AGGCCCGTAGGTACCGCAAT
TAGGCGTCCGACACTCACTT -> AGGCGTCCGACACTCACTTC
TAGGTACCGCAATGGCTGCA -> AGGTACCGCAATGGCTGCAT
TAGTAGGACGACGTGTCTGG -> AGTAGGACGACGTGTCTGGT
TAGTCCGGCAGTCATGAACT -> AGTCCGGCAGTCATGAACTG
TAGTTCACTGGCGGAAACGG -> AGTTCACTGGCGGAAACGGG
TAGTTCGGTCCACTGGCGGG -> AGTTCGGTCCACTGGCGGGT
TATAACGCGTTACGGCACTC -> ATAACGCGTTACGGCACTCT
TATACCTTCGCGCAGCGGGA -> ATACCTTCGCGCAGCGGGAC
TATACGTGACTGCCATTTTT -> ATACGTGACTGCCATTTTTT
TATAGATAAGCACGATCCAA -> ATAGATAAGCACGATCCAAA
TATAGCAAAAACTCGATCCA -> ATAGCAAAAACTCGATCCAA
TATAGTCCGGCAGTCATGAA -> ATAGTCCGGCAGTCATGAAC
TATCCCGTTGACTTTCCCCA -> ATCCCGTTGACTTTCCCCAG
TATCGACAACTGAACTGAGA -> ATCGACAACTGAACTGAGAA
TATGAGTTGCATGAGACCTG -> ATGAGTTGCATGAGACCTGG
TATGCATGGATGCGCATATT -> ATGCATGGATGCGCATATTG
TATGTATGCATGGATGCGCA -> ATGTATGCATGGATGCGCAT
TATGTTGCAACTATACCTTC -> ATGTTGCAACTATACCTTCG
TATTGATGTACCCAGTCACT -> ATTGATGTACCCAGTCACTC
TATTGCGGTCACACACTTTA -> ATTGCGGTCACACACTTTAG
TCACAAGCCCCCCCTCAGAC -> CACAAGCCCCCCCTCAGACC
TCACACACTTTAGAGCCGTC -> CACACACTTTAGAGCCGTCC
TCACGGCCCGCCAATTTGGA -> CACGGCCCGCCAATTTGGAC
TCACTAGCCACCTCCTGGGA -> CACTAGCCACCTCCTGGGAG
TCACTCGTCACGGCCCGCCA -> CACTCGTCACGGCCCGCCAA
TCACTGGCGGAAACGGGCTC -> CACTGGCGGAAACGGGCTCT
TCACTTCTGCGTCTAACAAC -> CACTTCTGCGTCTAACAACG
TCAGAATCCGAATTGTGGAT -> CAGAATCCGAATTGTGGATT
TCAGACCTGTAGTAGGACGA -> CAGACCTGTAGTAGGACGAC
TCAGCCACTAGTTCGGTCCA -> CAGCCACTAGTTCGGTCCAC
TCATGAACTGAAATGTGCGT -> CATGAACTGAAATGTGCGTG
TCATGTATACGTGACTGCCA -> CATGTATACGTGACTGCCAT
TCATTTTGAACCTGTGAATC -> CATTTTGAACCTGTGAATCG
TCCAAACGTGCATAAACTAT -> CCAAACGTGCATAAACTATT
TCCAATCGGTGTGCGACCTG -> CCAATCGGTGTGCGACCTGT
TCCACTGGCGGGTTAGGCCC -> CCACTGGCGGGTTAGGCCCG
TCCCACCTGGTCCTCGCCAT -> CCCACCTGGTCCTCGCCATC
TCCCCAGTTCGATTCGTGAC -> CCCCAGTTCGATTCGTGACT
TCCCCGCAGTTCGAGATGAG -> CCCCGCAGTTCGAGATGAGG
TCCCGTTGACTTTCCCCAGT -> CCCGTTGACTTTCCCCAGTT
TCCCTCGGTGCAAAATGCCG -> CCCTCGGTGCAAAATGCCGC
TCCGAATTGTGGATTGGGAG -> CCGAATTGTGGATTGGGAGA
TCCGACACTCACTTCTGCGT -> CCGACACTCACTTCTGCGTC
TCCGACTTGGGCAAGGATTA -> CCGACTTGGGCAAGGATTAG
TCCGGAACGTACACTATGTT -> CCGGAACGTACACTATGTTG
TCCGGCAGTCATGAACTGAA -> CCGGCAGTCATGAACTGAAA
TCCGGCGATTAACGGGGCAG -> CCGGCGATTAACGGGGCAGG
TCCGTTGCGCTTCTTTCTCA -> CCGTTGCGCTTCTTTCTCAT
TCCTACGGAGCGCTCCGGCG -> CCTACGGAGCGCTCCGGCGA
TCCTATAGATAAGCACGATC -> CCTATAGATAAGCACGATCC
TCCTATCGACAACTGAACTG -> CCTATCGACAACTGAACTGA
TCCTCGCCATCCGTTGCGCT -> CCTCGCCATCCGTTGCGCTT
TCCTGGGAGCTCCTTATAGC -> CCTGGGAGCTCCTTATAGCA
TCCTTATAGCAAAAACTCGA -> CCTTATAGCAAAAACTCGAT
TCGACAACTGAACTGAGAAG -> CGACAACTGAACTGAGAAGC
TCGACTAACGTACTCTGCCC -> CGACTAACGTACTCTGCCCA
TCGAGATGAGGTTCCTATCG -> CGAGATGAGGTTCCTATCGA
TCGAGTGCTTTGTAACCAGG -> CGAGTGCTTTGTAACCAGGG
TCGATCCAATCGGTGTGCGA -> CGATCCAATCGGTGTGCGAC
TCGATTCGTGACTGGTAGAA -> CGATTCGTGACTGGTAGAAG
TCGCCATCCGTTGCGCTTCT -> CGCCATCCGTTGCGCTTCTT
TCGCGCAGCGGGACTCTTCT -> CGCGCAGCGGGACTCTTCTC
TCGGAACCGTTTATGAGTTG -> CGGAACCGTTTATGAGTTGC
TCGGTCCACTGGCGGGTTAG -> CGGTCCACTGGCGGGTTAGG
TCGGTGCAAAATGCCGCTTC -> CGGTGCAAAATGCCGCTTCA
TCGGTGTGCGACCTGTCAGA -> CGGTGTGCGACCTGTCAGAA
TCGTCACGGCCCGCCAATTT -> CGTCACGGCCCGCCAATTTG
TCGTGACTGGTAGAAGATAT -> CGTGACTGGTAGAAGATATA
TCTAACAACGGCGGCGCTTA -> CTAACAACGGCGGCGCTTAG
TCTCATGTATACGTGACTGC -> CTCATGTATACGTGACTGCC
TCTCCCCGCAGTTCGAGATG -> CTCCCCGCAGTTCGAGATGA
TCTGCCCAGTCACAAGCCCC -> CTGCCCAGTCACAAGCCCCC
TCTGCGTCTAACAACGGCGG -> CTGCGTCTAACAACGGCGGC
TCTGGTGCATACACCCTATG -> CTGGTGCATACACCCTATGT
TCTTAAAATACAGCTTCCTA -> CTTAAAATACAGCTTCCTAT
TCTTCTCCCCGCAGTTCGAG -> CTTCTCCCCGCAGTTCGAGA
TCTTGATTTCGAGTGCTTTG -> CTTGATTTCGAGTGCTTTGT
TCTTGGCACTGTAACGCTAA -> CTTGGCACTGTAACGCTAAG
TCTTTCTCATGTATACGTGA -> CTTTCTCATGTATACGTGAC
TCTTTTACTATAACGCGTTA -> CTTTTACTATAACGCGTTAC
TGAAATGTGCGTGTTCACTA -> GAAATGTGCGTGTTCACTAG
TGAACCTGTGAATCGACTAA -> GAACCTGTGAATCGACTAAC
TGAACTGAAATGTGCGTGTT -> GAACTGAAATGTGCGTGTTC
TGAACTGAGAAGCTACCTTA -> GAACTGAGAAGCTACCTTAG
TGAATCGACTAACGTACTCT -> GAATCGACTAACGTACTCTG
TGACTGCCATTTTTTTGCCG -> GACTGCCATTTTTTTGCCGA
TGACTGGTAGAAGATATAGT -> GACTGGTAGAAGATATAGTC
TGACTTTCCCCAGTTCGATT -> GACTTTCCCCAGTTCGATTC
TGAGAAGCTACCTTAGAAGG -> GAGAAGCTACCTTAGAAGGT
TGAGACCTGGGGTACCCAGC -> GAGACCTGGGGTACCCAGCT
TGAGGTTCCTATCGACAACT -> GAGGTTCCTATCGACAACTG
TGAGTTGCATGAGACCTGGG -> GAGTTGCATGAGACCTGGGG
TGATGTACCCAGTCACTCGT -> GATGTACCCAGTCACTCGTC
TGATTTCGAGTGCTTTGTAA -> GATTTCGAGTGCTTTGTAAC
TGCAAAATGCCGCTTCATTT -> GCAAAATGCCGCTTCATTTT
TGCAACTATACCTTCGCGCA -> GCAACTATACCTTCGCGCAG
TGCATAAACTATTGATGTAC -> GCATAAACTATTGATGTACC
TGCATACACCCTATGTATGC -> GCATACACCCTATGTATGCA
TGCATCTTGGCACTGTAACG -> GCATCTTGGCACTGTAACGC
TGCATGAGACCTGGGGTACC -> GCATGAGACCTGGGGTACCC
TGCATGGATGCGCATATTGC -> GCATGGATGCGCATATTGCG
TGCCATTTTTTTGCCGATAT -> GCCATTTTTTTGCCGATATC
TGCCCAGTCACAAGCCCCCC -> GCCCAGTCACAAGCCCCCCC
TGCCGATATCCCGTTGACTT -> GCCGATATCCCGTTGACTTT
TGCCGCTTCATTTTGAACCT -> GCCGCTTCATTTTGAACCTG
TGCGACCTGTCAGAATCCGA -> GCGACCTGTCAGAATCCGAA
TGCGCATATTGCGGTCACAC -> GCGCATATTGCGGTCACACA
TGCGCTTCTTTCTCATGTAT -> GCGCTTCTTTCTCATGTATA
TGCGGTCACACACTTTAGAG -> GCGGTCACACACTTTAGAGC
TGCGTCTAACAACGGCGGCG -> GCGTCTAACAACGGCGGCGC
TGCGTGTTCACTAGCCACCT -> GCGTGTTCACTAGCCACCTC
TGCTTTGTAACCAGGGTAGA -> GCTTTGTAACCAGGGTAGAA
TGGACCTCCCTCGGTGCAAA -> GGACCTCCCTCGGTGCAAAA
TGGAGGAAACCGATACAGCT -> GGAGGAAACCGATACAGCTG
TGGATAACACTACTGGAGGA -> GGATAACACTACTGGAGGAA
TGGATGCGCATATTGCGGTC -> GGATGCGCATATTGCGGTCA
TGGATTGGGAGATGGATAAC -> GGATTGGGAGATGGATAACA
TGGCACTGTAACGCTAAGGA -> GGCACTGTAACGCTAAGGAT
TGGCGGAAACGGGCTCTTGA -> GGCGGAAACGGGCTCTTGAT
TGGCGGGTTAGGCCCGTAGG -> GGCGGGTTAGGCCCGTAGGT
TGGCTGCATCTTGGCACTGT -> GGCTGCATCTTGGCACTGTA
TGGGACGGAACGGGCCGCAC -> GGGACGGAACGGGCCGCACG
TGGGAGATGGATAACACTAC -> GGGAGATGGATAACACTACT
TGGGAGCTCCTTATAGCAAA -> GGGAGCTCCTTATAGCAAAA
TGGGCAAGGATTAGGCGTCC -> GGGCAAGGATTAGGCGTCCG
TGGGGCCTCTTTTACTATAA -> GGGGCCTCTTTTACTATAAC
TGGGGTACCCAGCTCAGCCA -> GGGGTACCCAGCTCAGCCAC
TGGTAGAAGATATAGTCCGG -> GGTAGAAGATATAGTCCGGC
TGGTCCTCGCCATCCGTTGC -> GGTCCTCGCCATCCGTTGCG
TGGTGCATACACCCTATGTA -> GGTGCATACACCCTATGTAT
TGTAACCAGGGTAGAACGGA -> GTAACCAGGGTAGAACGGAT
TGTAACGCTAAGGATTTTTG -> GTAACGCTAAGGATTTTTGG
TGTACCCAGTCACTCGTCAC -> GTACCCAGTCACTCGTCACG
TGTACGCCGCAGGCGTCCGA -> GTACGCCGCAGGCGTCCGAC
TGTAGTAGGACGACGTGTCT -> GTAGTAGGACGACGTGTCTG
TGTATACGTGACTGCCATTT -> GTATACGTGACTGCCATTTT
TGTATGCATGGATGCGCATA -> GTATGCATGGATGCGCATAT
TGTCAGAATCCGAATTGTGG -> GTCAGAATCCGAATTGTGGA
TGTCTGGTGCATACACCCTA -> GTCTGGTGCATACACCCTAT
TGTGAATCGACTAACGTACT -> GTGAATCGACTAACGTACTC
TGTGCGACCTGTCAGAATCC -> GTGCGACCTGTCAGAATCCG
TGTGCGTGTTCACTAGCCAC -> GTGCGTGTTCACTAGCCACC
TGTGGATTGGGAGATGGATA -> GTGGATTGGGAGATGGATAA
TGTTCACTAGCCACCTCCTG -> GTTCACTAGCCACCTCCTGG
TGTTGCAACTATACCTTCGC -> GTTGCAACTATACCTTCGCG
TTAAAATACAGCTTCCTATA -> TAAAATACAGCTTCCTATAG
TTACGGCACTCTTAAAATAC -> TACGGCACTCTTAAAATACA
TTACTATAACGCGTTACGGC -> TACTATAACGCGTTACGGCA
TTAGAAGGTTTGTACGCCGC -> TAGAAGGTTTGTACGCCGCA
TTAGAGCCGTCCGGAACGTA -> TAGAGCCGTCCGGAACGTAC
TTAGGCCCGTAGGTACCGCA -> TAGGCCCGTAGGTACCGCAA
TTAGGCGTCCGACACTCACT -> TAGGCGTCCGACACTCACTT
TTAGTTCACTGGCGGAAACG -> TAGTTCACTGGCGGAAACGG
TTATAGCAAAAACTCGATCC -> TATAGCAAAAACTCGATCCA
TTATGAGTTGCATGAGACCT -> TATGAGTTGCATGAGACCTG
TTCACTAGCCACCTCCTGGG -> TCACTAGCCACCTCCTGGGA
TTCACTGGCGGAAACGGGCT -> TCACTGGCGGAAACGGGCTC
TTCATTTTGAACCTGTGAAT -> TCATTTTGAACCTGTGAATC
TTCCCCAGTTCGATTCGTGA -> TCCCCAGTTCGATTCGTGAC
TTCCTATAGATAAGCACGAT -> TCCTATAGATAAGCACGATC
TTCCTATCGACAACTGAACT -> TCCTATCGACAACTGAACTG
TTCGAGATGAGGTTCCTATC -> TCGAGATGAGGTTCCTATCG
TTCGAGTGCTTTGTAACCAG -> TCGAGTGCTTTGTAACCAGG
TTCGATTCGTGACTGGTAGA -> TCGATTCGTGACTGGTAGAA
TTCGCGCAGCGGGACTCTTC -> TCGCGCAGCGGGACTCTTCT
TTCGGAACCGTTTATGAGTT -> TCGGAACCGTTTATGAGTTG
TTCGGTCCACTGGCGGGTTA -> TCGGTCCACTGGCGGGTTAG
TTCGTGACTGGTAGAAGATA -> TCGTGACTGGTAGAAGATAT
TTCTCATGTATACGTGACTG -> TCTCATGTATACGTGACTGC
TTCTCCCCGCAGTTCGAGAT -> TCTCCCCGCAGTTCGAGATG
TTCTGCGTCTAACAACGGCG -> TCTGCGTCTAACAACGGCGG
TTCTTTCTCATGTATACGTG -> TCTTTCTCATGTATACGTGA
TTGAACCTGTGAATCGACTA -> TGAACCTGTGAATCGACTAA
TTGACTTTCCCCAGTTCGAT -> TGACTTTCCCCAGTTCGATT
TTGATGTACCCAGTCACTCG -> TGATGTACCCAGTCACTCGT
TTGATTTCGAGTGCTTTGTA -> TGATTTCGAGTGCTTTGTAA
TTGCAACTATACCTTCGCGC -> TGCAACTATACCTTCGCGCA
TTGCATGAGACCTGGGGTAC -> TGCATGAGACCTGGGGTACC
TTGCCGATATCCCGTTGACT -> TGCCGATATCCCGTTGACTT
TTGCGCTTCTTTCTCATGTA -> TGCGCTTCTTTCTCATGTAT
TTGCGGTCACACACTTTAGA -> TGCGGTCACACACTTTAGAG
TTGGACCTCCCTCGGTGCAA -> TGGACCTCCCTCGGTGCAAA
TTGGCACTGTAACGCTAAGG -> TGGCACTGTAACGCTAAGGA
TTGGGAGATGGATAACACTA -> TGGGAGATGGATAACACTAC
TTGGGCAAGGATTAGGCGTC -> TGGGCAAGGATTAGGCGTCC
TTGGGGCCTCTTTTACTATA -> TGGGGCCTCTTTTACTATAA
TTGTAACCAGGGTAGAACGG -> TGTAACCAGGGTAGAACGGA
TTGTACGCCGCAGGCGTCCG -> TGTACGCCGCAGGCGTCCGA
TTGTGGATTGGGAGATGGAT -> TGTGGATTGGGAGATGGATA
TTTACTATAACGCGTTACGG -> TTACTATAACGCGTTACGGC
TTTAGAGCCGTCCGGAACGT -> TTAGAGCCGTCCGGAACGTA
TTTATGAGTTGCATGAGACC -> TTATGAGTTGCATGAGACCT
TTTCCCCAGTTCGATTCGTG -> TTCCCCAGTTCGATTCGTGA
TTTCGAGTGCTTTGTAACCA -> TTCGAGTGCTTTGTAACCAG
TTTCTCATGTATACGTGACT -> TTCTCATGTATACGTGACTG
TTTGAACCTGTGAATCGACT -> TTGAACCTGTGAATCGACTA
TTTGCCGATATCCCGTTGAC -> TTGCCGATATCCCGTTGACT
TTTGGACCTCCCTCGGTGCA -> TTGGACCTCCCTCGGTGCAA
TTTGGGGCCTCTTTTACTAT -> TTGGGGCCTCTTTTACTATA
TTTGTAACCAGGGTAGAACG -> TTGTAACCAGGGTAGAACGG
TTTGTACGCCGCAGGCGTCC -> TTGTACGCCGCAGGCGTCCG
TTTTACTATAACGCGTTACG -> TTTACTATAACGCGTTACGG
TTTTGAACCTGTGAATCGAC -> TTTGAACCTGTGAATCGACT
TTTTGCCGATATCCCGTTGA -> TTTGCCGATATCCCGTTGAC
TTTTGGGGCCTCTTTTACTA -> TTTGGGGCCTCTTTTACTAT
TTTTTGCCGATATCCCGTTG -> TTTTGCCGATATCCCGTTGA
TTTTTGGGGCCTCTTTTACT -> TTTTGGGGCCTCTTTTACTA
TTTTTTGCCGATATCCCGTT -> TTTTTGCCGATATCCCGTTG
TTTTTTTGCCGATATCCCGT -> TTTTTTGCCGATATCCCGTT