AAAAACATGGC -> AAAACATGGCC
AAAAACCTCCG -> AAAACCTCCGT
AAAACATGGCC -> AAACATGGCCT
AAAACCTCCGT -> AAACCTCCGTC
AAAATATTAAT -> AAATATTAATT
AAACACCGATG -> AACACCGATGC
AAACACTGAGT -> AACACTGAGTT
AAACACTGATA -> AACACTGATAG
AAACATGGCCT -> AACATGGCCTC
AAACCTCCGTC -> AACCTCCGTCC
AAACCTTATGT -> AACCTTATGTT
AAACTGAGGAT -> AACTGAGGATT
AAACTGAGTGG -> AACTGAGTGGA
AAAGCATTAAG -> AAGCATTAAGC
AAAGCCGTGAG -> AAGCCGTGAGT
AAAGCCTACTG -> AAGCCTACTGT
AAAGGAAACAC -> AAGGAAACACT
AAAGGCCATTG -> AAGGCCATTGT
AAATAATTCCT -> AATAATTCCTA
AAATAGCGGTC -> AATAGCGGTCC
AAATATAAAGC -> AATATAAAGCA
AAATATTAATT -> AATATTAATTT
AAATCCGAACT -> AATCCGAACTA
AAATCGGCGTG -> AATCGGCGTGA
AAATGGACCAT -> AATGGACCATG
AAATGGGATTA -> AATGGGATTAT
AAATGTATCGT -> AATGTATCGTT
AAATTAAAGCC -> AATTAAAGCCT
AACAACTTCGT -> ACAACTTCGTA
AACACATAACG -> ACACATAACGC
AACACCGATGC -> ACACCGATGCG
AACACTGAGTT -> ACACTGAGTTG
AACACTGATAG -> ACACTGATAGT
AACACTGCCTG -> ACACTGCCTGT
AACAGATTCAG -> ACAGATTCAGA
AACAGGTCGAA -> ACAGGTCGAAG
AACATGGCCTC -> ACATGGCCTCG
AACCAACAACT -> ACCAACAACTT
AACCATATATC -> ACCATATATCT
AACCCGCAATC -> ACCCGCAATCC
AACCGAAGGCT -> ACCGAAGGCTA
AACCGATGTTT -> ACCGATGTTTC
AACCTAAGGGC -> ACCTAAGGGCA
AACCTCCGTCC -> ACCTCCGTCCG
AACCTCGATCC -> ACCTCGATCCC
AACCTCTAGAG -> ACCTCTAGAGC
AACCTTATGTT -> ACCTTATGTTG
AACGATCGCGT -> ACGATCGCGTG
AACGATGCGTA -> ACGATGCGTAG
AACGCATCATC -> ACGCATCATCG
AACGCCCGGGG -> ACGCCCGGGGG
AACGGAATGCA -> ACGGAATGCAT
AACGGGACTGC -> ACGGGACTGCT
AACGGTTGTGT -> ACGGTTGTGTA
AACGTACGCCA -> ACGTACGCCAT
AACGTGGCTTG -> ACGTGGCTTGA
AACTAATATTG -> ACTAATATTGT
AACTACATTAT -> ACTACATTATC
AACTCATTGCC -> ACTCATTGCCT
AACTCTATCTT -> ACTCTATCTTG
AACTGAGGATT -> ACTGAGGATTT
AACTGAGTGGA -> ACTGAGTGGAG
AACTGTCACGA -> ACTGTCACGAT
AACTTCGTACT -> ACTTCGTACTT
AACTTTAAATT -> ACTTTAAATTA
AAGAAACCTTA -> AGAAACCTTAT
AAGCATTAAGC -> AGCATTAAGCC
AAGCCACTCTG -> AGCCACTCTGC
AAGCCGCTTCA -> AGCCGCTTCAG
AAGCCGGTGTC -> AGCCGGTGTCG
AAGCCGTGAGT -> AGCCGTGAGTG
AAGCCTACTGT -> AGCCTACTGTG
AAGCGAACGCC -> AGCGAACGCCC
AAGCGAACGGT -> AGCGAACGGTT
AAGCGACACTG -> AGCGACACTGC
AAGGAAACACT -> AGGAAACACTG
AAGGAAATAAT -> AGGAAATAATT
AAGGACATGGA -> AGGACATGGAG
AAGGCATGCCT -> AGGCATGCCTC
AAGGCCATTGT -> AGGCCATTGTA
AAGGCTACCCG -> AGGCTACCCGA
AAGGCTTGCGG -> AGGCTTGCGGG
AAGGGAAGTGG -> AGGGAAGTGGC
AAGGGCAGACG -> AGGGCAGACGA
AAGGTCGATTG -> AGGTCGATTGA
AAGTAGGTCAA -> AGTAGGTCAAA
AAGTATAGTCA -> AGTATAGTCAT
AAGTCCGTCAA -> AGTCCGTCAAA
AAGTGGCCAGG -> AGTGGCCAGGC
AAGTTTGGCCT -> AGTTTGGCCTA
AATAAGGGAAG -> ATAAGGGAAGT
AATAATTCCTA -> ATAATTCCTAC
AATACGCAAGC -> ATACGCAAGCG
AATAGCGGTCC -> ATAGCGGTCCG
AATATAAAGCA -> ATATAAAGCAT
AATATGTCCTG -> ATATGTCCTGA
AATATTAATTT -> ATATTAATTTG
AATATTGGTTA -> ATATTGGTTAA
AATATTGTATG -> ATATTGTATGC
AATCCGAACTA -> ATCCGAACTAC
AATCCTGGAGG -> ATCCTGGAGGC
AATCCTTGGCT -> ATCCTTGGCTC
AATCGGCGTGA -> ATCGGCGTGAA
AATCTACGATC -> ATCTACGATCT
AATCTTCCAGA -> ATCTTCCAGAA
AATGAGTTTTG -> ATGAGTTTTGG
AATGATAGCAG -> ATGATAGCAGA
AATGATCTCGG -> ATGATCTCGGA
AATGCATTCAA -> ATGCATTCAAC
AATGGAACAGG -> ATGGAACAGGT
AATGGACCATG -> ATGGACCATGG
AATGGGATTAT -> ATGGGATTATG
AATGTAGACAA -> ATGTAGACAAT
AATGTATCGTT -> ATGTATCGTTG
AATTAAAGCCT -> ATTAAAGCCTA
AATTAAATGTA -> ATTAAATGTAT
AATTACTAGCT -> ATTACTAGCTC
AATTATAATAT -> ATTATAATATG
AATTCCTACTG -> ATTCCTACTGG
AATTGAGAGCG -> ATTGAGAGCGC
AATTGATCATA -> ATTGATCATAC
AATTGGTGATC -> ATTGGTGATCT
AATTGTCTGAA -> ATTGTCTGAAT
AATTGTTCGCA -> ATTGTTCGCAG
AATTTGTTGAG -> ATTTGTTGAGT
ACAACACTGCC -> CAACACTGCCT
ACAACCATATA -> CAACCATATAT
ACAACCGAAGG -> CAACCGAAGGC
ACAACTTCGTA -> CAACTTCGTAC
ACAAGTATAGT -> CAAGTATAGTC
ACAATGTAGAC -> CAATGTAGACA
ACAATTGTTCG -> CAATTGTTCGC
ACACATAACGC -> CACATAACGCA
ACACATGCAAT -> CACATGCAATC
ACACCGATGCG -> CACCGATGCGC
ACACCTTCGGG -> CACCTTCGGGG
ACACGTTAACG -> CACGTTAACGT
ACACTAACCTC -> CACTAACCTCT
ACACTCCTGGA -> CACTCCTGGAA
ACACTGAGTTG -> CACTGAGTTGT
ACACTGATAGT -> CACTGATAGTC
ACACTGCATAT -> CACTGCATATT
ACACTGCCTGT -> CACTGCCTGTG
ACAGATTCAGA -> CAGATTCAGAG
ACAGATTGGGC -> CAGATTGGGCG
ACAGCCGAAGC -> CAGCCGAAGCC
ACAGCTGTTCG -> CAGCTGTTCGA
ACAGGACAATG -> CAGGACAATGT
ACAGGTCGAAG -> CAGGTCGAAGT
ACAGTACCATT -> CAGTACCATTC
ACAGTTGTACA -> CAGTTGTACAG
ACATAACGCAT -> CATAACGCATC
ACATGACTTCA -> CATGACTTCAC
ACATGCAATCT -> CATGCAATCTT
ACATGCATACC -> CATGCATACCG
ACATGCCGGTC -> CATGCCGGTCT
ACATGGAGGCG -> CATGGAGGCGT
ACATGGCCTCG -> CATGGCCTCGC
ACATTATCCAA -> CATTATCCAAC
ACCAACAACTT -> CCAACAACTTC
ACCAACTAATA -> CCAACTAATAT
ACCAAGCGAAC -> CCAAGCGAACG
ACCACACTCCT -> CCACACTCCTG
ACCAGATAGAT -> CCAGATAGATT
ACCAGTCTTAC -> CCAGTCTTACG
ACCATATATCT -> CCATATATCTA
ACCATGGCATA -> CCATGGCATAA
ACCATTCATAG -> CCATTCATAGT
ACCCAATTGAT -> CCCAATTGATC
ACCCCGGCTCC -> CCCCGGCTCCC
ACCCCTTCCTT -> CCCCTTCCTTC
ACCCGAAGCGA -> CCCGAAGCGAC
ACCCGCAATCC -> CCCGCAATCCT
ACCCGTCGCAC -> CCCGTCGCACT
ACCCTAGAACT -> CCCTAGAACTT
ACCGAAGGCTA -> CCGAAGGCTAC
ACCGACAACCA -> CCGACAACCAT
ACCGATGCGCT -> CCGATGCGCTC
ACCGATGTTTC -> CCGATGTTTCT
ACCGCGTAGTT -> CCGCGTAGTTC
ACCGGCATGAT -> CCGGCATGATC
ACCTAAGGGCA -> CCTAAGGGCAG
ACCTCCGTCCG -> CCTCCGTCCGC
ACCTCCTTTAT -> CCTCCTTTATT
ACCTCGATCCC -> CCTCGATCCCC
ACCTCTAAGGC -> CCTCTAAGGCT
ACCTCTAGAGC -> CCTCTAGAGCG
ACCTGTCATCC -> CCTGTCATCCA
ACCTTATGTTG -> CCTTATGTTGT
ACCTTCGGGGA -> CCTTCGGGGAA
ACGAATCTACG -> CGAATCTACGA
ACGACACCTTC -> CGACACCTTCG
ACGACCCTAGA -> CGACCCTAGAA
ACGAGTCCTAA -> CGAGTCCTAAA
ACGATCCGGTT -> CGATCCGGTTC
ACGATCGCGTG -> CGATCGCGTGA
ACGATCTCGCT -> CGATCTCGCTA
ACGATGCGTAG -> CGATGCGTAGG
ACGCAAGCGAA -> CGCAAGCGAAC
ACGCATCATCG -> CGCATCATCGC
ACGCCATGCGC -> CGCCATGCGCG
ACGCCCGGGGG -> CGCCCGGGGGG
ACGGAATGCAT -> CGGAATGCATT
ACGGCGTAGCG -> CGGCGTAGCGT
ACGGGACTGCT -> CGGGACTGCTC
ACGGGCAGGTA -> CGGGCAGGTAT
ACGGTCCTCCT -> CGGTCCTCCTC
ACGGTTGTGTA -> CGGTTGTGTAA
ACGTAAAGGCC -> CGTAAAGGCCA
ACGTACGCCAT -> CGTACGCCATG
ACGTATTAGTC -> CGTATTAGTCG
ACGTCGTCGTC -> CGTCGTCGTCG
ACGTGGCTTGA -> CGTGGCTTGAG
ACGTGTGCGCC -> CGTGTGCGCCC
ACGTTAACGTG -> CGTTAACGTGG
ACTAACCTCTA -> CTAACCTCTAG
ACTAATATTGT -> CTAATATTGTA
ACTACATGACT -> CTACATGACTT
ACTACATGCCG -> CTACATGCCGG
ACTACATTATC -> CTACATTATCC
ACTAGCACCAA -> CTAGCACCAAG
ACTAGCTCAAG -> CTAGCTCAAGG
ACTCATACCGA -> CTCATACCGAC
ACTCATTGCCT -> CTCATTGCCTC
ACTCCTAACAG -> CTCCTAACAGA
ACTCCTGGAAA -> CTCCTGGAAAC
ACTCCTTTAAT -> CTCCTTTAATG
ACTCCTTTAGT -> CTCCTTTAGTA
ACTCTATCTTG -> CTCTATCTTGC
ACTCTGCTGCT -> CTCTGCTGCTA
ACTCTGGCCAC -> CTCTGGCCACG
ACTGAGGATTT -> CTGAGGATTTA
ACTGAGTGGAG -> CTGAGTGGAGG
ACTGAGTTGTC -> CTGAGTTGTCA
ACTGATAGTCC -> CTGATAGTCCT
ACTGCATATTA -> CTGCATATTAG
ACTGCCTGTGC -> CTGCCTGTGCG
ACTGCTCCTAC -> CTGCTCCTACA
ACTGGTCTATC -> CTGGTCTATCC
ACTGTCACGAT -> CTGTCACGATC
ACTGTGAACGT -> CTGTGAACGTA
ACTGTGCGACA -> CTGTGCGACAC
ACTTCACCAGA -> CTTCACCAGAT
ACTTCGCCAGT -> CTTCGCCAGTG
ACTTCGTACTT -> CTTCGTACTTC
ACTTCTCAAAT -> CTTCTCAAATC
ACTTTAAATTA -> CTTTAAATTAA
ACTTTAAGGAA -> CTTTAAGGAAA
AGAAACCTTAT -> GAAACCTTATG
AGAAAGGAAAC -> GAAAGGAAACA
AGAACGATGCG -> GAACGATGCGT
AGAACTTTAAA -> GAACTTTAAAT
AGAATTACTAG -> GAATTACTAGC
AGACAATTGTT -> GACAATTGTTC
AGACAGCTGTT -> GACAGCTGTTC
AGACATGCATA -> GACATGCATAC
AGACGACCCTA -> GACGACCCTAG
AGACGAGTCCT -> GACGAGTCCTA
AGAGCGCCAGC -> GAGCGCCAGCA
AGAGCGCGCTT -> GAGCGCGCTTC
AGAGGCAGACA -> GAGGCAGACAT
AGAGGGTGGGC -> GAGGGTGGGCC
AGAGTCACTAC -> GAGTCACTACA
AGATAGATTAG -> GATAGATTAGA
AGATCTGCCGA -> GATCTGCCGAA
AGATTAGACAG -> GATTAGACAGC
AGATTCAGAGG -> GATTCAGAGGG
AGATTCTATCT -> GATTCTATCTT
AGATTGGGCGT -> GATTGGGCGTG
AGATTGTCCCT -> GATTGTCCCTA
AGCACCAAGCG -> GCACCAAGCGA
AGCACTTCGCC -> GCACTTCGCCA
AGCAGAGTCAC -> GCAGAGTCACT
AGCAGTCCAAA -> GCAGTCCAAAT
AGCATTAAGCC -> GCATTAAGCCA
AGCCACTCTGC -> GCCACTCTGCT
AGCCCTCCTCT -> GCCCTCCTCTG
AGCCGAAGCCG -> GCCGAAGCCGC
AGCCGCTTCAG -> GCCGCTTCAGA
AGCCGGTGTCG -> GCCGGTGTCGG
AGCCGTGAGTG -> GCCGTGAGTGC
AGCCTACTGTG -> GCCTACTGTGC
AGCCTGGCTAC -> GCCTGGCTACA
AGCGAACGCCC -> GCGAACGCCCG
AGCGAACGGTT -> GCGAACGGTTG
AGCGACACTGC -> GCGACACTGCA
AGCGCCAGCAG -> GCGCCAGCAGT
AGCGCGCTTCT -> GCGCGCTTCTC
AGCGGTCCGCC -> GCGGTCCGCCA
AGCGTCTTACA -> GCGTCTTACAG
AGCTATACCCG -> GCTATACCCGT
AGCTCAAGGAC -> GCTCAAGGACA
AGCTCCGACCG -> GCTCCGACCGG
AGCTGTAAGTA -> GCTGTAAGTAG
AGCTGTTCGAA -> GCTGTTCGAAC
AGGAAACACTG -> GGAAACACTGA
AGGAAATAATT -> GGAAATAATTC
AGGAATTGGTG -> GGAATTGGTGA
AGGACAATGTA -> GGACAATGTAG
AGGACATGGAG -> GGACATGGAGG
AGGACCTGTCA -> GGACCTGTCAT
AGGAGCCTGGC -> GGAGCCTGGCT
AGGAGTTATGG -> GGAGTTATGGC
AGGATTTACTA -> GGATTTACTAG
AGGCACGTATT -> GGCACGTATTA
AGGCAGACATG -> GGCAGACATGC
AGGCATGCCTC -> GGCATGCCTCG
AGGCCATTGTA -> GGCCATTGTAT
AGGCGTACCCC -> GGCGTACCCCT
AGGCTACCCGA -> GGCTACCCGAA
AGGCTTCAGCT -> GGCTTCAGCTC
AGGCTTGCGGG -> GGCTTGCGGGG
AGGGAAGTGGC -> GGGAAGTGGCC
AGGGCACGGCG -> GGGCACGGCGT
AGGGCAGACGA -> GGGCAGACGAC
AGGGGAACTCA -> GGGGAACTCAT
AGGGGTAGAAC -> GGGGTAGAACG
AGGGTGGGCCT -> GGGTGGGCCTA
AGGGTGTAACC -> GGGTGTAACCT
AGGTAATTGTC -> GGTAATTGTCT
AGGTATTGGCA -> GGTATTGGCAA
AGGTCAAATAT -> GGTCAAATATA
AGGTCGAAGTT -> GGTCGAAGTTT
AGGTCGATTGA -> GGTCGATTGAC
AGGTCGGACCA -> GGTCGGACCAG
AGGTTCGGCTT -> GGTTCGGCTTC
AGTAAACACCG -> GTAAACACCGA
AGTAATATTGG -> GTAATATTGGT
AGTACCATTCA -> GTACCATTCAT
AGTAGCTATAC -> GTAGCTATACC
AGTAGCTGTAA -> GTAGCTGTAAG
AGTAGGTCAAA -> GTAGGTCAAAT
AGTAGTCGCTC -> GTAGTCGCTCC
AGTATACTCAT -> GTATACTCATA
AGTATAGTCAT -> GTATAGTCATG
AGTATCGCTCC -> GTATCGCTCCT
AGTCACTACAT -> GTCACTACATG
AGTCATGAACC -> GTCATGAACCC
AGTCCAAATGG -> GTCCAAATGGG
AGTCCGTCAAA -> GTCCGTCAAAT
AGTCCTAAATA -> GTCCTAAATAG
AGTCCTTGGTG -> GTCCTTGGTGA
AGTCGCTAGGT -> GTCGCTAGGTA
AGTCGCTCCGG -> GTCGCTCCGGG
AGTCGTTTCTC -> GTCGTTTCTCG
AGTCTTACGAA -> GTCTTACGAAT
AGTCTTGATGC -> GTCTTGATGCG
AGTGAGGGCAC -> GTGAGGGCACG
AGTGCGTGAGA -> GTGCGTGAGAT
AGTGGAGGACC -> GTGGAGGACCT
AGTGGCCAGGC -> GTGGCCAGGCT
AGTGGTAATGA -> GTGGTAATGAT
AGTTATAGGAG -> GTTATAGGAGC
AGTTATGGCAC -> GTTATGGCACT
AGTTCAACACA -> GTTCAACACAT
AGTTGTACAGA -> GTTGTACAGAT
AGTTGTCACCT -> GTTGTCACCTC
AGTTTGGCCTA -> GTTTGGCCTAT
AGTTTTGGATG -> GTTTTGGATGA
ATAAAATATTA -> TAAAATATTAA
ATAAACTGAGG -> TAAACTGAGGA
ATAAAGCATTA -> TAAAGCATTAA
ATAACGCATCA -> TAACGCATCAT
ATAAGGGAAGT -> TAAGGGAAGTG
ATAATATGTCC -> TAATATGTCCT
ATAATTAAATG -> TAATTAAATGT
ATAATTCCTAC -> TAATTCCTACT
ATACACGTTAA -> TACACGTTAAC
ATACCCGTCGC -> TACCCGTCGCA
ATACCGACAAC -> TACCGACAACC
ATACCGCGTAG -> TACCGCGTAGT
ATACGCAAGCG -> TACGCAAGCGA
ATACGTCGTCG -> TACGTCGTCGT
ATACTCATACC -> TACTCATACCG
ATAGATTAGAC -> TAGATTAGACA
ATAGCAGAGTC -> TAGCAGAGTCA
ATAGCCCTCCT -> TAGCCCTCCTC
ATAGCGGTCCG -> TAGCGGTCCGC
ATAGGAGCCTG -> TAGGAGCCTGG
ATAGTCATGAA -> TAGTCATGAAC
ATAGTCCTTGG -> TAGTCCTTGGT
ATAGTCGTTTC -> TAGTCGTTTCT
ATATAAAGCAT -> TATAAAGCATT
ATATATCTAGG -> TATATCTAGGG
ATATCCCAAGG -> TATCCCAAGGT
ATATCTAGGGG -> TATCTAGGGGT
ATATGTCCTGA -> TATGTCCTGAT
ATATTAATTTG -> TATTAATTTGT
ATATTAGGTCG -> TATTAGGTCGG
ATATTGGTTAA -> TATTGGTTAAC
ATATTGTATGC -> TATTGTATGCC
ATCAGGTTCGG -> TCAGGTTCGGC
ATCATACGTCG -> TCATACGTCGT
ATCATCGCCAG -> TCATCGCCAGT
ATCCAACGGGA -> TCCAACGGGAC
ATCCAACTGTC -> TCCAACTGTCA
ATCCCAAAGCC -> TCCCAAAGCCG
ATCCCAAGGTC -> TCCCAAGGTCG
ATCCCCCCGCA -> TCCCCCCGCAA
ATCCGAACTAC -> TCCGAACTACA
ATCCGGTTCGG -> TCCGGTTCGGT
ATCCTACTCCT -> TCCTACTCCTA
ATCCTGGAGGC -> TCCTGGAGGCA
ATCCTTGGCTC -> TCCTTGGCTCG
ATCGCCAGTAA -> TCGCCAGTAAT
ATCGCGTGAGT -> TCGCGTGAGTA
ATCGCTCCTTT -> TCGCTCCTTTT
ATCGGCGTGAA -> TCGGCGTGAAT
ATCGTTGATGA -> TCGTTGATGAT
ATCTAAGCCGG -> TCTAAGCCGGT
ATCTACGATCT -> TCTACGATCTC
ATCTAGGGGTA -> TCTAGGGGTAG
ATCTCGCTAAC -> TCTCGCTAACG
ATCTCGGAGCA -> TCTCGGAGCAC
ATCTCTATATC -> TCTCTATATCC
ATCTGCCGAAG -> TCTGCCGAAGG
ATCTTCCAGAA -> TCTTCCAGAAT
ATCTTGCTGGT -> TCTTGCTGGTC
ATCTTTGGCAT -> TCTTTGGCATG
ATGAACCCGCA -> TGAACCCGCAA
ATGACGTAAAG -> TGACGTAAAGG
ATGACTTCACC -> TGACTTCACCA
ATGAGTTTTGG -> TGAGTTTTGGA
ATGATAGCAGA -> TGATAGCAGAG
ATGATCTCGGA -> TGATCTCGGAG
ATGATCTCTAT -> TGATCTCTATA
ATGATGCGAGA -> TGATGCGAGAA
ATGATGCGATG -> TGATGCGATGC
ATGCAATCTTC -> TGCAATCTTCC
ATGCATACCGC -> TGCATACCGCG
ATGCATTCAAC -> TGCATTCAACC
ATGCCCATTAT -> TGCCCATTATC
ATGCCGGTCTC -> TGCCGGTCTCG
ATGCCTCGCCG -> TGCCTCGCCGT
ATGCCTGAGAT -> TGCCTGAGATT
ATGCGAGAAAG -> TGCGAGAAAGG
ATGCGATGCCT -> TGCGATGCCTG
ATGCGATGGTG -> TGCGATGGTGT
ATGCGCGACTC -> TGCGCGACTCC
ATGCGCTCAGT -> TGCGCTCAGTG
ATGCGTAGGAG -> TGCGTAGGAGT
ATGCTCATGTA -> TGCTCATGTAA
ATGGAACAGGT -> TGGAACAGGTC
ATGGACCATGG -> TGGACCATGGC
ATGGAGGCGTA -> TGGAGGCGTAC
ATGGCACTACA -> TGGCACTACAT
ATGGCATAATT -> TGGCATAATTA
ATGGCCTCGCC -> TGGCCTCGCCG
ATGGCTGGGCA -> TGGCTGGGCAT
ATGGGATTATG -> TGGGATTATGA
ATGGTGTTGTG -> TGGTGTTGTGG
ATGTAACGATC -> TGTAACGATCG
ATGTAATAAGG -> TGTAATAAGGG
ATGTAGACAAT -> TGTAGACAATT
ATGTATCGTTG -> TGTATCGTTGA
ATGTCCTGATT -> TGTCCTGATTC
ATGTTGTCCAT -> TGTTGTCCATG
ATGTTTCTTGG -> TGTTTCTTGGA
ATTAAAGCCTA -> TTAAAGCCTAC
ATTAAATCGGC -> TTAAATCGGCG
ATTAAATGTAT -> TTAAATGTATC
ATTAAGCCACT -> TTAAGCCACTC
ATTAATTTGTT -> TTAATTTGTTG
ATTACTAGCTC -> TTACTAGCTCA
ATTAGACAGCT -> TTAGACAGCTG
ATTAGGTCGGA -> TTAGGTCGGAC
ATTAGTCGCTA -> TTAGTCGCTAG
ATTATAATATG -> TTATAATATGT
ATTATCCAACT -> TTATCCAACTG
ATTATCCTACT -> TTATCCTACTC
ATTATGACGTA -> TTATGACGTAA
ATTCAACCGAT -> TTCAACCGATG
ATTCAGAGGGT -> TTCAGAGGGTG
ATTCATAGTCG -> TTCATAGTCGT
ATTCCTACTGG -> TTCCTACTGGT
ATTCGACAGTA -> TTCGACAGTAC
ATTCTATCTTT -> TTCTATCTTTG
ATTGACGGTCC -> TTGACGGTCCT
ATTGAGAGCGC -> TTGAGAGCGCC
ATTGATCATAC -> TTGATCATACG
ATTGCCTCACC -> TTGCCTCACCC
ATTGGCAACTC -> TTGGCAACTCT
ATTGGGCGTGT -> TTGGGCGTGTA
ATTGGTGATCT -> TTGGTGATCTA
ATTGGTTAACC -> TTGGTTAACCT
ATTGTATGCCC -> TTGTATGCCCA
ATTGTATGCTC -> TTGTATGCTCA
ATTGTCCCTAG -> TTGTCCCTAGT
ATTGTCTGAAT -> TTGTCTGAATG
ATTGTTCGCAG -> TTGTTCGCAGA
ATTTACTAGCA -> TTTACTAGCAC
ATTTCTACTCT -> TTTCTACTCTG
ATTTGACCAAC -> TTTGACCAACT
ATTTGTTGAGT -> TTTGTTGAGTA
CAAAGCCGTGA -> AAAGCCGTGAG
CAAATATAAAG -> AAATATAAAGC
CAAATCCGAAC -> AAATCCGAACT
CAAATGGACCA -> AAATGGACCAT
CAAATGGGATT -> AAATGGGATTA
CAACAACTTCG -> AACAACTTCGT
CAACACATAAC -> AACACATAACG
CAACACTGCCT -> AACACTGCCTG
CAACCATATAT -> AACCATATATC
CAACCGAAGGC -> AACCGAAGGCT
CAACCGATGTT -> AACCGATGTTT
CAACGGGACTG -> AACGGGACTGC
CAACTAATATT -> AACTAATATTG
CAACTCTATCT -> AACTCTATCTT
CAACTGTCACG -> AACTGTCACGA
CAACTTCGTAC -> AACTTCGTACT
CAAGCGAACGC -> AAGCGAACGCC
CAAGCGAACGG -> AAGCGAACGGT
CAAGGACATGG -> AAGGACATGGA
CAAGGTCGATT -> AAGGTCGATTG
CAAGTATAGTC -> AAGTATAGTCA
CAAGTCCGTCA -> AAGTCCGTCAA
CAATCCTGGAG -> AATCCTGGAGG
CAATCCTTGGC -> AATCCTTGGCT
CAATCTTCCAG -> AATCTTCCAGA
CAATGTAGACA -> AATGTAGACAA
CAATTGAGAGC -> AATTGAGAGCG
CAATTGATCAT -> AATTGATCATA
CAATTGTTCGC -> AATTGTTCGCA
CACAAGTATAG -> ACAAGTATAGT
CACACTCCTGG -> ACACTCCTGGA
CACAGCCGAAG -> ACAGCCGAAGC
CACATAACGCA -> ACATAACGCAT
CACATGCAATC -> ACATGCAATCT
CACCAAGCGAA -> ACCAAGCGAAC
CACCAGATAGA -> ACCAGATAGAT
CACCCAATTGA -> ACCCAATTGAT
CACCGATGCGC -> ACCGATGCGCT
CACCTCTAAGG -> ACCTCTAAGGC
CACCTTCGGGG -> ACCTTCGGGGA
CACGACACCTT -> ACGACACCTTC
CACGATCCGGT -> ACGATCCGGTT
CACGGCGTAGC -> ACGGCGTAGCG
CACGTATTAGT -> ACGTATTAGTC
CACGTGTGCGC -> ACGTGTGCGCC
CACGTTAACGT -> ACGTTAACGTG
CACTAACCTCT -> ACTAACCTCTA
CACTACATGAC -> ACTACATGACT
CACTACATGCC -> ACTACATGCCG
CACTCCTGGAA -> ACTCCTGGAAA
CACTCTGCTGC -> ACTCTGCTGCT
CACTGAGTTGT -> ACTGAGTTGTC
CACTGATAGTC -> ACTGATAGTCC
CACTGCATATT -> ACTGCATATTA
CACTGCCTGTG -> ACTGCCTGTGC
CACTGTGAACG -> ACTGTGAACGT
CACTTCGCCAG -> ACTTCGCCAGT
CAGAATTACTA -> AGAATTACTAG
CAGACATGCAT -> AGACATGCATA
CAGACGACCCT -> AGACGACCCTA
CAGACGAGTCC -> AGACGAGTCCT
CAGAGGCAGAC -> AGAGGCAGACA
CAGAGGGTGGG -> AGAGGGTGGGC
CAGAGTCACTA -> AGAGTCACTAC
CAGATAGATTA -> AGATAGATTAG
CAGATTCAGAG -> AGATTCAGAGG
CAGATTCTATC -> AGATTCTATCT
CAGATTGGGCG -> AGATTGGGCGT
CAGCAGTCCAA -> AGCAGTCCAAA
CAGCCGAAGCC -> AGCCGAAGCCG
CAGCTCCGACC -> AGCTCCGACCG
CAGCTGTTCGA -> AGCTGTTCGAA
CAGGACAATGT -> AGGACAATGTA
CAGGCTTCAGC -> AGGCTTCAGCT
CAGGTATTGGC -> AGGTATTGGCA
CAGGTCGAAGT -> AGGTCGAAGTT
CAGGTTCGGCT -> AGGTTCGGCTT
CAGTAAACACC -> AGTAAACACCG
CAGTAATATTG -> AGTAATATTGG
CAGTACCATTC -> AGTACCATTCA
CAGTAGTCGCT -> AGTAGTCGCTC
CAGTCCAAATG -> AGTCCAAATGG
CAGTCTTACGA -> AGTCTTACGAA
CAGTCTTGATG -> AGTCTTGATGC
CAGTGAGGGCA -> AGTGAGGGCAC
CAGTGGTAATG -> AGTGGTAATGA
CAGTTGTACAG -> AGTTGTACAGA
CATAACGCATC -> ATAACGCATCA
CATAATTAAAT -> ATAATTAAATG
CATACACGTTA -> ATACACGTTAA
CATACCGACAA -> ATACCGACAAC
CATACCGCGTA -> ATACCGCGTAG
CATACGTCGTC -> ATACGTCGTCG
CATAGCCCTCC -> ATAGCCCTCCT
CATAGTCGTTT -> ATAGTCGTTTC
CATATATCTAG -> ATATATCTAGG
CATATTAGGTC -> ATATTAGGTCG
CATCATCGCCA -> ATCATCGCCAG
CATCCAACGGG -> ATCCAACGGGA
CATCGCCAGTA -> ATCGCCAGTAA
CATGAACCCGC -> ATGAACCCGCA
CATGACTTCAC -> ATGACTTCACC
CATGATCTCTA -> ATGATCTCTAT
CATGCAATCTT -> ATGCAATCTTC
CATGCATACCG -> ATGCATACCGC
CATGCCGGTCT -> ATGCCGGTCTC
CATGCCTCGCC -> ATGCCTCGCCG
CATGCGCGACT -> ATGCGCGACTC
CATGGAGGCGT -> ATGGAGGCGTA
CATGGCATAAT -> ATGGCATAATT
CATGGCCTCGC -> ATGGCCTCGCC
CATGGCTGGGC -> ATGGCTGGGCA
CATGTAACGAT -> ATGTAACGATC
CATGTAATAAG -> ATGTAATAAGG
CATTAAGCCAC -> ATTAAGCCACT
CATTATCCAAC -> ATTATCCAACT
CATTATCCTAC -> ATTATCCTACT
CATTCAACCGA -> ATTCAACCGAT
CATTCATAGTC -> ATTCATAGTCG
CATTGCCTCAC -> ATTGCCTCACC
CATTGTATGCT -> ATTGTATGCTC
CATTTCTACTC -> ATTTCTACTCT
CATTTGACCAA -> ATTTGACCAAC
CCAAAGCCGTG -> CAAAGCCGTGA
CCAAATGGGAT -> CAAATGGGATT
CCAACAACTTC -> CAACAACTTCG
CCAACGGGACT -> CAACGGGACTG
CCAACTAATAT -> CAACTAATATT
CCAACTGTCAC -> CAACTGTCACG
CCAAGCGAACG -> CAAGCGAACGC
CCAAGGTCGAT -> CAAGGTCGATT
CCAATCCTTGG -> CAATCCTTGGC
CCAATTGAGAG -> CAATTGAGAGC
CCAATTGATCA -> CAATTGATCAT
CCACAAGTATA -> CACAAGTATAG
CCACACTCCTG -> CACACTCCTGG
CCACGTGTGCG -> CACGTGTGCGC
CCACTCTGCTG -> CACTCTGCTGC
CCAGAATTACT -> CAGAATTACTA
CCAGATAGATT -> CAGATAGATTA
CCAGATTCTAT -> CAGATTCTATC
CCAGCAGTCCA -> CAGCAGTCCAA
CCAGGCTTCAG -> CAGGCTTCAGC
CCAGTAAACAC -> CAGTAAACACC
CCAGTAATATT -> CAGTAATATTG
CCAGTCTTACG -> CAGTCTTACGA
CCAGTGGTAAT -> CAGTGGTAATG
CCATATATCTA -> CATATATCTAG
CCATGCGCGAC -> CATGCGCGACT
CCATGGCATAA -> CATGGCATAAT
CCATGTAACGA -> CATGTAACGAT
CCATTATCCTA -> CATTATCCTAC
CCATTCATAGT -> CATTCATAGTC
CCATTGTATGC -> CATTGTATGCT
CCCAAAGCCGT -> CCAAAGCCGTG
CCCAAGGTCGA -> CCAAGGTCGAT
CCCAATTGAGA -> CCAATTGAGAG
CCCAATTGATC -> CCAATTGATCA
CCCAGTAAACA -> CCAGTAAACAC
CCCATTATCCT -> CCATTATCCTA
CCCCCCGCAAG -> CCCCCGCAAGT
CCCCCGCAAGT -> CCCCGCAAGTC
CCCCGCAAGTC -> CCCGCAAGTCC
CCCCGCGAGTA -> CCCGCGAGTAG
CCCCGGCTCCC -> CCCGGCTCCCT
CCCCTTCCTTC -> CCCTTCCTTCC
CCCGAAGCGAC -> CCGAAGCGACA
CCCGCAAGTCC -> CCGCAAGTCCG
CCCGCAATCCT -> CCGCAATCCTG
CCCGCGAGTAG -> CCGCGAGTAGC
CCCGGCTCCCT -> CCGGCTCCCTT
CCCGGGGGGTC -> CCGGGGGGTCA
CCCGGTTTGGC -> CCGGTTTGGCA
CCCGTCGCACT -> CCGTCGCACTG
CCCTAGAACTT -> CCTAGAACTTT
CCCTAGTTATA -> CCTAGTTATAG
CCCTCCTCTGC -> CCTCCTCTGCG
CCCTCTTGTGC -> CCTCTTGTGCA
CCCTGCCAATC -> CCTGCCAATCC
CCCTTCCTTCC -> CCTTCCTTCCT
CCCTTGTCATT -> CCTTGTCATTT
CCGAACTACAT -> CGAACTACATT
CCGAAGCCGCT -> CGAAGCCGCTT
CCGAAGCGACA -> CGAAGCGACAC
CCGAAGGCATG -> CGAAGGCATGC
CCGAAGGCTAC -> CGAAGGCTACC
CCGACAACCAT -> CGACAACCATA
CCGACCGGCAT -> CGACCGGCATG
CCGATGCGCTC -> CGATGCGCTCA
CCGATGTTTCT -> CGATGTTTCTT
CCGCAAGTCCG -> CGCAAGTCCGT
CCGCAATCCTG -> CGCAATCCTGG
CCGCCAGATTC -> CGCCAGATTCT
CCGCGAGTAGC -> CGCGAGTAGCT
CCGCGTAGTTC -> CGCGTAGTTCA
CCGCTAATTAT -> CGCTAATTATA
CCGCTTCAGAG -> CGCTTCAGAGG
CCGGCATGATC -> CGGCATGATCT
CCGGCTCCCTT -> CGGCTCCCTTG
CCGGGCCACAA -> CGGGCCACAAG
CCGGGGGGTCA -> CGGGGGGTCAT
CCGGTCTCGCT -> CGGTCTCGCTG
CCGGTGTCGGG -> CGGTGTCGGGT
CCGGTTCGGTC -> CGGTTCGGTCC
CCGGTTTGGCA -> CGGTTTGGCAG
CCGTCAAATGG -> CGTCAAATGGA
CCGTCCGCTAA -> CGTCCGCTAAT
CCGTCGCACTG -> CGTCGCACTGT
CCGTGAGTGCG -> CGTGAGTGCGT
CCGTTTGCCCA -> CGTTTGCCCAG
CCTAAACTGAG -> CTAAACTGAGT
CCTAAATAGCG -> CTAAATAGCGG
CCTAACAGATT -> CTAACAGATTC
CCTAAGGGCAG -> CTAAGGGCAGA
CCTACAACCGA -> CTACAACCGAA
CCTACTCCTAA -> CTACTCCTAAC
CCTACTGGTCT -> CTACTGGTCTA
CCTACTGTGCG -> CTACTGTGCGA
CCTAGAACTTT -> CTAGAACTTTA
CCTAGTTATAG -> CTAGTTATAGG
CCTATAAAATA -> CTATAAAATAT
CCTCACCCAAT -> CTCACCCAATT
CCTCCGTCCGC -> CTCCGTCCGCT
CCTCCTCTGCG -> CTCCTCTGCGA
CCTCCTCTTGG -> CTCCTCTTGGA
CCTCCTTTATT -> CTCCTTTATTA
CCTCGATCCCC -> CTCGATCCCCC
CCTCGCCGTGA -> CTCGCCGTGAC
CCTCGCCGTTT -> CTCGCCGTTTG
CCTCTAAGGCT -> CTCTAAGGCTT
CCTCTAGAGCG -> CTCTAGAGCGC
CCTCTGCGACC -> CTCTGCGACCT
CCTCTTGGACA -> CTCTTGGACAC
CCTCTTGTGCA -> CTCTTGTGCAT
CCTGAGATTGT -> CTGAGATTGTC
CCTGATTCGAC -> CTGATTCGACA
CCTGCCAATCC -> CTGCCAATCCT
CCTGGAAACAC -> CTGGAAACACT
CCTGGAGGCAC -> CTGGAGGCACG
CCTGGCTACAA -> CTGGCTACAAC
CCTGTCATCCA -> CTGTCATCCAA
CCTGTGCGACC -> CTGTGCGACCA
CCTTATGTTGT -> CTTATGTTGTC
CCTTCCTTCCT -> CTTCCTTCCTT
CCTTCCTTGAC -> CTTCCTTGACA
CCTTCGGGGAA -> CTTCGGGGAAT
CCTTGACAGGA -> CTTGACAGGAC
CCTTGGCTCGA -> CTTGGCTCGAA
CCTTGGTGACT -> CTTGGTGACTC
CCTTGTCATTT -> CTTGTCATTTG
CCTTTAATGAG -> CTTTAATGAGT
CCTTTAGTATA -> CTTTAGTATAC
CCTTTATTAAA -> CTTTATTAAAT
CCTTTTTCTTG -> CTTTTTCTTGT
CGAAAAACCTC -> GAAAAACCTCC
CGAACCAACAA -> GAACCAACAAC
CGAACGCCCGG -> GAACGCCCGGG
CGAACGGTTGT -> GAACGGTTGTG
CGAACTACATT -> GAACTACATTA
CGAAGCCGCTT -> GAAGCCGCTTC
CGAAGCGACAC -> GAAGCGACACT
CGAAGGCATGC -> GAAGGCATGCC
CGAAGGCTACC -> GAAGGCTACCC
CGAAGTTTGGC -> GAAGTTTGGCC
CGAATCTACGA -> GAATCTACGAT
CGACAACCATA -> GACAACCATAT
CGACACCTTCG -> GACACCTTCGG
CGACACTAACC -> GACACTAACCT
CGACACTGCAT -> GACACTGCATA
CGACAGTACCA -> GACAGTACCAT
CGACCACACTC -> GACCACACTCC
CGACCCCGGCT -> GACCCCGGCTC
CGACCCTAGAA -> GACCCTAGAAC
CGACCGGCATG -> GACCGGCATGA
CGACCTCCTTT -> GACCTCCTTTA
CGACTCCTTTA -> GACTCCTTTAA
CGACTTTAAGG -> GACTTTAAGGA
CGAGAAAGGAA -> GAGAAAGGAAA
CGAGTAGCTAT -> GAGTAGCTATA
CGAGTCCTAAA -> GAGTCCTAAAT
CGATCCCCCCG -> GATCCCCCCGC
CGATCCGGTTC -> GATCCGGTTCG
CGATCGCGTGA -> GATCGCGTGAG
CGATCTCGCTA -> GATCTCGCTAA
CGATGCCTGAG -> GATGCCTGAGA
CGATGCGCTCA -> GATGCGCTCAG
CGATGCGTAGG -> GATGCGTAGGA
CGATGGTGTTG -> GATGGTGTTGT
CGATGTTTCTT -> GATGTTTCTTG
CGATTGACGGT -> GATTGACGGTC
CGCAAGCGAAC -> GCAAGCGAACG
CGCAAGTCCGT -> GCAAGTCCGTC
CGCAATCCTGG -> GCAATCCTGGA
CGCACTGTGAA -> GCACTGTGAAC
CGCAGACGAGT -> GCAGACGAGTC
CGCATCATCGC -> GCATCATCGCC
CGCCAGATTCT -> GCCAGATTCTA
CGCCAGCAGTC -> GCCAGCAGTCC
CGCCAGTAATA -> GCCAGTAATAT
CGCCAGTGGTA -> GCCAGTGGTAA
CGCCATGCGCG -> GCCATGCGCGA
CGCCCGGGGGG -> GCCCGGGGGGT
CGCCCTGCCAA -> GCCCTGCCAAT
CGCCGTTTGCC -> GCCGTTTGCCC
CGCGACTCCTT -> GCGACTCCTTT
CGCGAGTAGCT -> GCGAGTAGCTA
CGCGCTTCTCC -> GCGCTTCTCCC
CGCGTAGTTCA -> GCGTAGTTCAA
CGCGTGAGTAT -> GCGTGAGTATC
CGCTAACGGAA -> GCTAACGGAAT
CGCTAATTATA -> GCTAATTATAA
CGCTAGGTAAT -> GCTAGGTAATT
CGCTCAGTGAG -> GCTCAGTGAGG
CGCTCCGGGCC -> GCTCCGGGCCA
CGCTCCTTTTT -> GCTCCTTTTTC
CGCTGATAAAC -> GCTGATAAACT
CGCTTCAGAGG -> GCTTCAGAGGC
CGCTTCTCCCG -> GCTTCTCCCGG
CGGAATGCATT -> GGAATGCATTC
CGGACCAGTCT -> GGACCAGTCTT
CGGAGCACTTC -> GGAGCACTTCG
CGGCATGATCT -> GGCATGATCTC
CGGCGTAGCGT -> GGCGTAGCGTC
CGGCGTGAATG -> GGCGTGAATGG
CGGCTCCCTTG -> GGCTCCCTTGT
CGGCTTCCCCG -> GGCTTCCCCGC
CGGGACTGCTC -> GGGACTGCTCC
CGGGCAGGTAT -> GGGCAGGTATT
CGGGCCACAAG -> GGGCCACAAGT
CGGGGAATACG -> GGGGAATACGC
CGGGGGGTCAT -> GGGGGGTCATT
CGGGGTCGTCA -> GGGGTCGTCAC
CGGGTTGGGTT -> GGGTTGGGTTT
CGGTCCCTCTT -> GGTCCCTCTTG
CGGTCCGCCAG -> GGTCCGCCAGA
CGGTCCTCCTC -> GGTCCTCCTCT
CGGTCTCGCTG -> GGTCTCGCTGA
CGGTGTCGGGT -> GGTGTCGGGTT
CGGTTCGGTCC -> GGTTCGGTCCC
CGGTTGTGTAA -> GGTTGTGTAAG
CGGTTTGGCAG -> GGTTTGGCAGT
CGTAAAGGCCA -> GTAAAGGCCAT
CGTACCCCTTC -> GTACCCCTTCC
CGTACGCCATG -> GTACGCCATGC
CGTACTTCTCA -> GTACTTCTCAA
CGTAGCGTCTT -> GTAGCGTCTTA
CGTAGGAGTTA -> GTAGGAGTTAT
CGTAGTTCAAC -> GTAGTTCAACA
CGTATTAGTCG -> GTATTAGTCGC
CGTCAAATGGA -> GTCAAATGGAC
CGTCACAGCCG -> GTCACAGCCGA
CGTCCGCTAAT -> GTCCGCTAATT
CGTCGCACTGT -> GTCGCACTGTG
CGTCGTCGTCG -> GTCGTCGTCGT
CGTCGTCGTTC -> GTCGTCGTTCG
CGTCGTTCGAC -> GTCGTTCGACT
CGTCTTACAGT -> GTCTTACAGTT
CGTGAATGGAA -> GTGAATGGAAC
CGTGAGATCTG -> GTGAGATCTGC
CGTGAGTATCG -> GTGAGTATCGC
CGTGAGTGCGT -> GTGAGTGCGTG
CGTGGCTTGAG -> GTGGCTTGAGG
CGTGTACGGGC -> GTGTACGGGCA
CGTGTGCGCCC -> GTGTGCGCCCT
CGTTAACGTGG -> GTTAACGTGGC
CGTTCGACTTT -> GTTCGACTTTA
CGTTGATGATG -> GTTGATGATGC
CGTTTCTCGAC -> GTTTCTCGACC
CGTTTGCCCAG -> GTTTGCCCAGT
CTAAACTGAGT -> TAAACTGAGTG
CTAAATAGCGG -> TAAATAGCGGT
CTAACAGATTC -> TAACAGATTCA
CTAACCTCTAG -> TAACCTCTAGA
CTAACGGAATG -> TAACGGAATGC
CTAAGCCGGTG -> TAAGCCGGTGT
CTAAGGCTTGC -> TAAGGCTTGCG
CTAAGGGCAGA -> TAAGGGCAGAC
CTAATATTGTA -> TAATATTGTAT
CTAATTATAAT -> TAATTATAATA
CTACAACACTG -> TACAACACTGC
CTACAACCGAA -> TACAACCGAAG
CTACATGACTT -> TACATGACTTC
CTACATGCCGG -> TACATGCCGGT
CTACATTATCC -> TACATTATCCA
CTACCCGAAGC -> TACCCGAAGCG
CTACGATCTCG -> TACGATCTCGC
CTACTCCTAAC -> TACTCCTAACA
CTACTCTGGCC -> TACTCTGGCCA
CTACTGGTCTA -> TACTGGTCTAT
CTACTGTGCGA -> TACTGTGCGAC
CTAGAACTTTA -> TAGAACTTTAA
CTAGAGCGCGC -> TAGAGCGCGCT
CTAGCACCAAG -> TAGCACCAAGC
CTAGCTCAAGG -> TAGCTCAAGGA
CTAGGAATTGG -> TAGGAATTGGT
CTAGGGGTAGA -> TAGGGGTAGAA
CTAGGTAATTG -> TAGGTAATTGT
CTAGTTATAGG -> TAGTTATAGGA
CTATAAAATAT -> TATAAAATATT
CTATACCCGTC -> TATACCCGTCG
CTATATCCCAA -> TATATCCCAAG
CTATCCCAAAG -> TATCCCAAAGC
CTATCTTGCTG -> TATCTTGCTGG
CTATCTTTGGC -> TATCTTTGGCA
CTCAAATCCGA -> TCAAATCCGAA
CTCAAGGACAT -> TCAAGGACATG
CTCACCCAATT -> TCACCCAATTG
CTCAGTGAGGG -> TCAGTGAGGGC
CTCATACCGAC -> TCATACCGACA
CTCATGTAATA -> TCATGTAATAA
CTCATTGCCTC -> TCATTGCCTCA
CTCCCGGTTTG -> TCCCGGTTTGG
CTCCCTTGTCA -> TCCCTTGTCAT
CTCCGACCGGC -> TCCGACCGGCA
CTCCGGGCCAC -> TCCGGGCCACA
CTCCGTCCGCT -> TCCGTCCGCTA
CTCCTAACAGA -> TCCTAACAGAT
CTCCTACAACC -> TCCTACAACCG
CTCCTCTGCGA -> TCCTCTGCGAC
CTCCTCTTGGA -> TCCTCTTGGAC
CTCCTGGAAAC -> TCCTGGAAACA
CTCCTTTAATG -> TCCTTTAATGA
CTCCTTTAGTA -> TCCTTTAGTAT
CTCCTTTATTA -> TCCTTTATTAA
CTCCTTTTTCT -> TCCTTTTTCTT
CTCGAAAAACC -> TCGAAAAACCT
CTCGACCCCGG -> TCGACCCCGGC
CTCGATCCCCC -> TCGATCCCCCC
CTCGCCGTTTG -> TCGCCGTTTGC
CTCGCTAACGG -> TCGCTAACGGA
CTCGCTGATAA -> TCGCTGATAAA
CTCGGAGCACT -> TCGGAGCACTT
CTCTAAGGCTT -> TCTAAGGCTTG
CTCTAGAGCGC -> TCTAGAGCGCG
CTCTATATCCC -> TCTATATCCCA
CTCTATCTTGC -> TCTATCTTGCT
CTCTGCGACCT -> TCTGCGACCTC
CTCTGCTGCTA -> TCTGCTGCTAG
CTCTGGCCACG -> TCTGGCCACGT
CTCTTGGACAC -> TCTTGGACACA
CTCTTGTGCAT -> TCTTGTGCATA
CTGAATGATCT -> TGAATGATCTC
CTGAGATTGTC -> TGAGATTGTCC
CTGAGGATTTA -> TGAGGATTTAC
CTGAGTGGAGG -> TGAGTGGAGGA
CTGAGTTGTCA -> TGAGTTGTCAC
CTGATAAACTG -> TGATAAACTGA
CTGATAGTCCT -> TGATAGTCCTT
CTGATTCGACA -> TGATTCGACAG
CTGCATATTAG -> TGCATATTAGG
CTGCCAATCCT -> TGCCAATCCTT
CTGCCGAAGGC -> TGCCGAAGGCA
CTGCCTGTGCG -> TGCCTGTGCGA
CTGCGACCTCC -> TGCGACCTCCT
CTGCTAGGAAT -> TGCTAGGAATT
CTGCTCCTACA -> TGCTCCTACAA
CTGCTGCTAGG -> TGCTGCTAGGA
CTGGAAACACT -> TGGAAACACTG
CTGGAGGCACG -> TGGAGGCACGT
CTGGCCACGTG -> TGGCCACGTGT
CTGGCTACAAC -> TGGCTACAACA
CTGGGCATACA -> TGGGCATACAC
CTGGTCACGAC -> TGGTCACGACA
CTGGTCTATCC -> TGGTCTATCCC
CTGTAAGTAGG -> TGTAAGTAGGT
CTGTCACGATC -> TGTCACGATCC
CTGTCATCCAA -> TGTCATCCAAC
CTGTGAACGTA -> TGTGAACGTAC
CTGTGCGACAC -> TGTGCGACACT
CTGTGCGACCA -> TGTGCGACCAC
CTGTTCGAACC -> TGTTCGAACCA
CTTACAGTTGT -> TTACAGTTGTA
CTTACGAATCT -> TTACGAATCTA
CTTATGTTGTC -> TTATGTTGTCC
CTTCACCAGAT -> TTCACCAGATA
CTTCAGAGGCA -> TTCAGAGGCAG
CTTCAGCTCCG -> TTCAGCTCCGA
CTTCCAGAATT -> TTCCAGAATTA
CTTCCCCGCGA -> TTCCCCGCGAG
CTTCCTTCCTT -> TTCCTTCCTTG
CTTCCTTGACA -> TTCCTTGACAG
CTTCGCCAGTG -> TTCGCCAGTGG
CTTCGGGGAAT -> TTCGGGGAATA
CTTCGTACTTC -> TTCGTACTTCT
CTTCTCAAATC -> TTCTCAAATCC
CTTCTCCCGGT -> TTCTCCCGGTT
CTTGACAGGAC -> TTGACAGGACA
CTTGAGGGTGT -> TTGAGGGTGTA
CTTGATGCGAT -> TTGATGCGATG
CTTGCGGGGTC -> TTGCGGGGTCG
CTTGCTGGTCA -> TTGCTGGTCAC
CTTGGACACAT -> TTGGACACATG
CTTGGAGGGGA -> TTGGAGGGGAA
CTTGGCTCGAA -> TTGGCTCGAAA
CTTGGTGACTC -> TTGGTGACTCC
CTTGTCATTTG -> TTGTCATTTGA
CTTGTGCATAG -> TTGTGCATAGC
CTTGTTTCCCA -> TTGTTTCCCAA
CTTTAAATTAA -> TTTAAATTAAA
CTTTAAGGAAA -> TTTAAGGAAAT
CTTTAATGAGT -> TTTAATGAGTT
CTTTAGTATAC -> TTTAGTATACT
CTTTATTAAAT -> TTTATTAAATC
CTTTGGCATGG -> TTTGGCATGGC
CTTTTTCTTGT -> TTTTTCTTGTT
GAAAAACCTCC -> AAAAACCTCCG
GAAACACTGAG -> AAACACTGAGT
GAAACACTGAT -> AAACACTGATA
GAAACCTTATG -> AAACCTTATGT
GAAAGGAAACA -> AAAGGAAACAC
GAAATAATTCC -> AAATAATTCCT
GAACAGGTCGA -> AACAGGTCGAA
GAACCAACAAC -> AACCAACAACT
GAACCCGCAAT -> AACCCGCAATC
GAACGATGCGT -> AACGATGCGTA
GAACGCCCGGG -> AACGCCCGGGG
GAACGGTTGTG -> AACGGTTGTGT
GAACGTACGCC -> AACGTACGCCA
GAACTACATTA -> AACTACATTAT
GAACTCATTGC -> AACTCATTGCC
GAACTTTAAAT -> AACTTTAAATT
GAAGCCGCTTC -> AAGCCGCTTCA
GAAGCGACACT -> AAGCGACACTG
GAAGGCATGCC -> AAGGCATGCCT
GAAGGCTACCC -> AAGGCTACCCG
GAAGTGGCCAG -> AAGTGGCCAGG
GAAGTTTGGCC -> AAGTTTGGCCT
GAATACGCAAG -> AATACGCAAGC
GAATCTACGAT -> AATCTACGATC
GAATGATCTCG -> AATGATCTCGG
GAATGCATTCA -> AATGCATTCAA
GAATGGAACAG -> AATGGAACAGG
GAATTACTAGC -> AATTACTAGCT
GAATTGGTGAT -> AATTGGTGATC
GACAACCATAT -> ACAACCATATA
GACAATGTAGA -> ACAATGTAGAC
GACAATTGTTC -> ACAATTGTTCG
GACACATGCAA -> ACACATGCAAT
GACACCTTCGG -> ACACCTTCGGG
GACACTAACCT -> ACACTAACCTC
GACACTGCATA -> ACACTGCATAT
GACAGCTGTTC -> ACAGCTGTTCG
GACAGGACAAT -> ACAGGACAATG
GACAGTACCAT -> ACAGTACCATT
GACATGCATAC -> ACATGCATACC
GACATGGAGGC -> ACATGGAGGCG
GACCAACTAAT -> ACCAACTAATA
GACCACACTCC -> ACCACACTCCT
GACCAGTCTTA -> ACCAGTCTTAC
GACCATGGCAT -> ACCATGGCATA
GACCCCGGCTC -> ACCCCGGCTCC
GACCCTAGAAC -> ACCCTAGAACT
GACCGGCATGA -> ACCGGCATGAT
GACCTCCTTTA -> ACCTCCTTTAT
GACCTGTCATC -> ACCTGTCATCC
GACGACCCTAG -> ACGACCCTAGA
GACGAGTCCTA -> ACGAGTCCTAA
GACGGTCCTCC -> ACGGTCCTCCT
GACGTAAAGGC -> ACGTAAAGGCC
GACTCCTTTAA -> ACTCCTTTAAT
GACTCCTTTAG -> ACTCCTTTAGT
GACTGCTCCTA -> ACTGCTCCTAC
GACTTCACCAG -> ACTTCACCAGA
GACTTTAAGGA -> ACTTTAAGGAA
GAGAAAGGAAA -> AGAAAGGAAAC
GAGAGCGCCAG -> AGAGCGCCAGC
GAGATCTGCCG -> AGATCTGCCGA
GAGATTGTCCC -> AGATTGTCCCT
GAGCACTTCGC -> AGCACTTCGCC
GAGCCTGGCTA -> AGCCTGGCTAC
GAGCGCCAGCA -> AGCGCCAGCAG
GAGCGCGCTTC -> AGCGCGCTTCT
GAGGACCTGTC -> AGGACCTGTCA
GAGGATTTACT -> AGGATTTACTA
GAGGCACGTAT -> AGGCACGTATT
GAGGCAGACAT -> AGGCAGACATG
GAGGCGTACCC -> AGGCGTACCCC
GAGGGCACGGC -> AGGGCACGGCG
GAGGGGAACTC -> AGGGGAACTCA
GAGGGTGGGCC -> AGGGTGGGCCT
GAGGGTGTAAC -> AGGGTGTAACC
GAGTAGCTATA -> AGTAGCTATAC
GAGTAGCTGTA -> AGTAGCTGTAA
GAGTATCGCTC -> AGTATCGCTCC
GAGTCACTACA -> AGTCACTACAT
GAGTCCTAAAT -> AGTCCTAAATA
GAGTGCGTGAG -> AGTGCGTGAGA
GAGTGGAGGAC -> AGTGGAGGACC
GAGTTATGGCA -> AGTTATGGCAC
GAGTTGTCACC -> AGTTGTCACCT
GAGTTTTGGAT -> AGTTTTGGATG
GATAAACTGAG -> ATAAACTGAGG
GATAGATTAGA -> ATAGATTAGAC
GATAGCAGAGT -> ATAGCAGAGTC
GATAGTCCTTG -> ATAGTCCTTGG
GATCAGGTTCG -> ATCAGGTTCGG
GATCATACGTC -> ATCATACGTCG
GATCCCCCCGC -> ATCCCCCCGCA
GATCCGGTTCG -> ATCCGGTTCGG
GATCGCGTGAG -> ATCGCGTGAGT
GATCTAAGCCG -> ATCTAAGCCGG
GATCTCGCTAA -> ATCTCGCTAAC
GATCTCGGAGC -> ATCTCGGAGCA
GATCTCTATAT -> ATCTCTATATC
GATCTGCCGAA -> ATCTGCCGAAG
GATGATGCGAG -> ATGATGCGAGA
GATGATGCGAT -> ATGATGCGATG
GATGCCTGAGA -> ATGCCTGAGAT
GATGCGAGAAA -> ATGCGAGAAAG
GATGCGATGCC -> ATGCGATGCCT
GATGCGATGGT -> ATGCGATGGTG
GATGCGCTCAG -> ATGCGCTCAGT
GATGCGTAGGA -> ATGCGTAGGAG
GATGGTGTTGT -> ATGGTGTTGTG
GATGTTTCTTG -> ATGTTTCTTGG
GATTAGACAGC -> ATTAGACAGCT
GATTATGACGT -> ATTATGACGTA
GATTCAGAGGG -> ATTCAGAGGGT
GATTCGACAGT -> ATTCGACAGTA
GATTCTATCTT -> ATTCTATCTTT
GATTGACGGTC -> ATTGACGGTCC
GATTGGGCGTG -> ATTGGGCGTGT
GATTGTCCCTA -> ATTGTCCCTAG
GATTTACTAGC -> ATTTACTAGCA
GCAACTCTATC -> CAACTCTATCT
GCAAGCGAACG -> CAAGCGAACGG
GCAAGTCCGTC -> CAAGTCCGTCA
GCAATCCTGGA -> CAATCCTGGAG
GCAATCTTCCA -> CAATCTTCCAG
GCACCAAGCGA -> CACCAAGCGAA
GCACGGCGTAG -> CACGGCGTAGC
GCACGTATTAG -> CACGTATTAGT
GCACTACATGA -> CACTACATGAC
GCACTGTGAAC -> CACTGTGAACG
GCACTTCGCCA -> CACTTCGCCAG
GCAGACATGCA -> CAGACATGCAT
GCAGACGACCC -> CAGACGACCCT
GCAGACGAGTC -> CAGACGAGTCC
GCAGAGTCACT -> CAGAGTCACTA
GCAGGTATTGG -> CAGGTATTGGC
GCAGTAGTCGC -> CAGTAGTCGCT
GCAGTCCAAAT -> CAGTCCAAATG
GCATAATTAAA -> CATAATTAAAT
GCATACACGTT -> CATACACGTTA
GCATACCGCGT -> CATACCGCGTA
GCATAGCCCTC -> CATAGCCCTCC
GCATATTAGGT -> CATATTAGGTC
GCATCATCGCC -> CATCATCGCCA
GCATGATCTCT -> CATGATCTCTA
GCATGCCTCGC -> CATGCCTCGCC
GCATGGCTGGG -> CATGGCTGGGC
GCATTAAGCCA -> CATTAAGCCAC
GCATTCAACCG -> CATTCAACCGA
GCCAATCCTTG -> CCAATCCTTGG
GCCACAAGTAT -> CCACAAGTATA
GCCACGTGTGC -> CCACGTGTGCG
GCCACTCTGCT -> CCACTCTGCTG
GCCAGATTCTA -> CCAGATTCTAT
GCCAGCAGTCC -> CCAGCAGTCCA
GCCAGGCTTCA -> CCAGGCTTCAG
GCCAGTAATAT -> CCAGTAATATT
GCCAGTGGTAA -> CCAGTGGTAAT
GCCATGCGCGA -> CCATGCGCGAC
GCCATTGTATG -> CCATTGTATGC
GCCCAGTAAAC -> CCCAGTAAACA
GCCCATTATCC -> CCCATTATCCT
GCCCGGGGGGT -> CCCGGGGGGTC
GCCCTCCTCTG -> CCCTCCTCTGC
GCCCTGCCAAT -> CCCTGCCAATC
GCCGAAGCCGC -> CCGAAGCCGCT
GCCGAAGGCAT -> CCGAAGGCATG
GCCGCTTCAGA -> CCGCTTCAGAG
GCCGGTCTCGC -> CCGGTCTCGCT
GCCGGTGTCGG -> CCGGTGTCGGG
GCCGTGAGTGC -> CCGTGAGTGCG
GCCGTTTGCCC -> CCGTTTGCCCA
GCCTAAACTGA -> CCTAAACTGAG
GCCTACTGTGC -> CCTACTGTGCG
GCCTATAAAAT -> CCTATAAAATA
GCCTCACCCAA -> CCTCACCCAAT
GCCTCGCCGTG -> CCTCGCCGTGA
GCCTCGCCGTT -> CCTCGCCGTTT
GCCTGAGATTG -> CCTGAGATTGT
GCCTGGCTACA -> CCTGGCTACAA
GCCTGTGCGAC -> CCTGTGCGACC
GCGAACGCCCG -> CGAACGCCCGG
GCGAACGGTTG -> CGAACGGTTGT
GCGACACTAAC -> CGACACTAACC
GCGACACTGCA -> CGACACTGCAT
GCGACCACACT -> CGACCACACTC
GCGACCTCCTT -> CGACCTCCTTT
GCGACTCCTTT -> CGACTCCTTTA
GCGAGAAAGGA -> CGAGAAAGGAA
GCGAGTAGCTA -> CGAGTAGCTAT
GCGATGCCTGA -> CGATGCCTGAG
GCGATGGTGTT -> CGATGGTGTTG
GCGCCAGCAGT -> CGCCAGCAGTC
GCGCCCTGCCA -> CGCCCTGCCAA
GCGCGACTCCT -> CGCGACTCCTT
GCGCGCTTCTC -> CGCGCTTCTCC
GCGCTCAGTGA -> CGCTCAGTGAG
GCGCTTCTCCC -> CGCTTCTCCCG
GCGGGGTCGTC -> CGGGGTCGTCA
GCGGTCCGCCA -> CGGTCCGCCAG
GCGTACCCCTT -> CGTACCCCTTC
GCGTAGCGTCT -> CGTAGCGTCTT
GCGTAGGAGTT -> CGTAGGAGTTA
GCGTAGTTCAA -> CGTAGTTCAAC
GCGTCTTACAG -> CGTCTTACAGT
GCGTGAATGGA -> CGTGAATGGAA
GCGTGAGATCT -> CGTGAGATCTG
GCGTGAGTATC -> CGTGAGTATCG
GCGTGTACGGG -> CGTGTACGGGC
GCTAACGGAAT -> CTAACGGAATG
GCTAATTATAA -> CTAATTATAAT
GCTACAACACT -> CTACAACACTG
GCTACCCGAAG -> CTACCCGAAGC
GCTAGGAATTG -> CTAGGAATTGG
GCTAGGTAATT -> CTAGGTAATTG
GCTATACCCGT -> CTATACCCGTC
GCTCAAGGACA -> CTCAAGGACAT
GCTCAGTGAGG -> CTCAGTGAGGG
GCTCATGTAAT -> CTCATGTAATA
GCTCCCTTGTC -> CTCCCTTGTCA
GCTCCGACCGG -> CTCCGACCGGC
GCTCCGGGCCA -> CTCCGGGCCAC
GCTCCTACAAC -> CTCCTACAACC
GCTCCTTTTTC -> CTCCTTTTTCT
GCTCGAAAAAC -> CTCGAAAAACC
GCTGATAAACT -> CTGATAAACTG
GCTGCTAGGAA -> CTGCTAGGAAT
GCTGGGCATAC -> CTGGGCATACA
GCTGGTCACGA -> CTGGTCACGAC
GCTGTAAGTAG -> CTGTAAGTAGG
GCTGTTCGAAC -> CTGTTCGAACC
GCTTCAGAGGC -> CTTCAGAGGCA
GCTTCAGCTCC -> CTTCAGCTCCG
GCTTCCCCGCG -> CTTCCCCGCGA
GCTTCTCCCGG -> CTTCTCCCGGT
GCTTGAGGGTG -> CTTGAGGGTGT
GCTTGCGGGGT -> CTTGCGGGGTC
GGAAACACTGA -> GAAACACTGAG,GAAACACTGAT
GGAAATAATTC -> GAAATAATTCC
GGAACAGGTCG -> GAACAGGTCGA
GGAACTCATTG -> GAACTCATTGC
GGAAGTGGCCA -> GAAGTGGCCAG
GGAATACGCAA -> GAATACGCAAG
GGAATGCATTC -> GAATGCATTCA
GGAATTGGTGA -> GAATTGGTGAT
GGACAATGTAG -> GACAATGTAGA
GGACACATGCA -> GACACATGCAA
GGACATGGAGG -> GACATGGAGGC
GGACCAGTCTT -> GACCAGTCTTA
GGACCATGGCA -> GACCATGGCAT
GGACCTGTCAT -> GACCTGTCATC
GGACTGCTCCT -> GACTGCTCCTA
GGAGCACTTCG -> GAGCACTTCGC
GGAGCCTGGCT -> GAGCCTGGCTA
GGAGGACCTGT -> GAGGACCTGTC
GGAGGCACGTA -> GAGGCACGTAT
GGAGGCGTACC -> GAGGCGTACCC
GGAGGGGAACT -> GAGGGGAACTC
GGAGTTATGGC -> GAGTTATGGCA
GGATGATGCGA -> GATGATGCGAG
GGATTATGACG -> GATTATGACGT
GGATTTACTAG -> GATTTACTAGC
GGCAACTCTAT -> GCAACTCTATC
GGCACGGCGTA -> GCACGGCGTAG
GGCACGTATTA -> GCACGTATTAG
GGCACTACATG -> GCACTACATGA
GGCAGACATGC -> GCAGACATGCA
GGCAGACGACC -> GCAGACGACCC
GGCAGGTATTG -> GCAGGTATTGG
GGCAGTAGTCG -> GCAGTAGTCGC
GGCATAATTAA -> GCATAATTAAA
GGCATACACGT -> GCATACACGTT
GGCATGATCTC -> GCATGATCTCT
GGCATGCCTCG -> GCATGCCTCGC
GGCATGGCTGG -> GCATGGCTGGG
GGCCACAAGTA -> GCCACAAGTAT
GGCCACGTGTG -> GCCACGTGTGC
GGCCAGGCTTC -> GCCAGGCTTCA
GGCCATTGTAT -> GCCATTGTATG
GGCCTAAACTG -> GCCTAAACTGA
GGCCTATAAAA -> GCCTATAAAAT
GGCCTCGCCGT -> GCCTCGCCGTT
GGCGTACCCCT -> GCGTACCCCTT
GGCGTAGCGTC -> GCGTAGCGTCT
GGCGTGAATGG -> GCGTGAATGGA
GGCGTGTACGG -> GCGTGTACGGG
GGCTACAACAC -> GCTACAACACT
GGCTACCCGAA -> GCTACCCGAAG
GGCTCCCTTGT -> GCTCCCTTGTC
GGCTCGAAAAA -> GCTCGAAAAAC
GGCTGGGCATA -> GCTGGGCATAC
GGCTTCAGCTC -> GCTTCAGCTCC
GGCTTCCCCGC -> GCTTCCCCGCG
GGCTTGAGGGT -> GCTTGAGGGTG
GGCTTGCGGGG -> GCTTGCGGGGT
GGGAACTCATT -> GGAACTCATTG
GGGAAGTGGCC -> GGAAGTGGCCA
GGGAATACGCA -> GGAATACGCAA
GGGACTGCTCC -> GGACTGCTCCT
GGGATTATGAC -> GGATTATGACG
GGGCACGGCGT -> GGCACGGCGTA
GGGCAGACGAC -> GGCAGACGACC
GGGCAGGTATT -> GGCAGGTATTG
GGGCATACACG -> GGCATACACGT
GGGCCACAAGT -> GGCCACAAGTA
GGGCCTAAACT -> GGCCTAAACTG
GGGCGTGTACG -> GGCGTGTACGG
GGGGAACTCAT -> GGGAACTCATT
GGGGAATACGC -> GGGAATACGCA
GGGGGGTCATT -> GGGGGTCATTT
GGGGGTCATTT -> GGGGTCATTTC
GGGGTAGAACG -> GGGTAGAACGA
GGGGTCATTTC -> GGGTCATTTCT
GGGGTCGTCAC -> GGGTCGTCACA
GGGTAGAACGA -> GGTAGAACGAT
GGGTCATTTCT -> GGTCATTTCTA
GGGTCGTCACA -> GGTCGTCACAG
GGGTGGGCCTA -> GGTGGGCCTAA
GGGTGTAACCT -> GGTGTAACCTC
GGGTTGGGTTT -> GGTTGGGTTTA
GGGTTTAAAAA -> GGTTTAAAAAC
GGTAATGATAG -> GTAATGATAGC
GGTAATTGTCT -> GTAATTGTCTG
GGTAGAACGAT -> GTAGAACGATG
GGTATTGGCAA -> GTATTGGCAAC
GGTCAAATATA -> GTCAAATATAA
GGTCACGACAC -> GTCACGACACC
GGTCATTTCTA -> GTCATTTCTAC
GGTCCCTCTTG -> GTCCCTCTTGT
GGTCCGCCAGA -> GTCCGCCAGAT
GGTCCTCCTCT -> GTCCTCCTCTT
GGTCGAAGTTT -> GTCGAAGTTTG
GGTCGATTGAC -> GTCGATTGACG
GGTCGGACCAG -> GTCGGACCAGT
GGTCGTCACAG -> GTCGTCACAGC
GGTCTATCCCA -> GTCTATCCCAA
GGTCTCGCTGA -> GTCTCGCTGAT
GGTGACTCCTT -> GTGACTCCTTT
GGTGATCAGGT -> GTGATCAGGTT
GGTGATCTAAG -> GTGATCTAAGC
GGTGGGCCTAA -> GTGGGCCTAAA
GGTGTAACCTC -> GTGTAACCTCG
GGTGTCGGGTT -> GTGTCGGGTTG
GGTGTTGTGGT -> GTGTTGTGGTG
GGTTAACCTAA -> GTTAACCTAAG
GGTTCGGCTTC -> GTTCGGCTTCC
GGTTCGGTCCC -> GTTCGGTCCCT
GGTTGGGTTTA -> GTTGGGTTTAA
GGTTGTGTAAG -> GTTGTGTAAGA
GGTTTAAAAAC -> GTTTAAAAACA
GGTTTGGCAGT -> GTTTGGCAGTA
GTAAACACCGA -> TAAACACCGAT
GTAAAGGCCAT -> TAAAGGCCATT
GTAACCTCGAT -> TAACCTCGATC
GTAACGATCGC -> TAACGATCGCG
GTAAGAAACCT -> TAAGAAACCTT
GTAAGTAGGTC -> TAAGTAGGTCA
GTAATAAGGGA -> TAATAAGGGAA
GTAATATTGGT -> TAATATTGGTT
GTAATGATAGC -> TAATGATAGCA
GTAATTGTCTG -> TAATTGTCTGA
GTACAGATTGG -> TACAGATTGGG
GTACCATTCAT -> TACCATTCATA
GTACCCCTTCC -> TACCCCTTCCT
GTACGCCATGC -> TACGCCATGCG
GTACGGGCAGG -> TACGGGCAGGT
GTACTTCTCAA -> TACTTCTCAAA
GTAGAACGATG -> TAGAACGATGC
GTAGACAATTG -> TAGACAATTGT
GTAGCGTCTTA -> TAGCGTCTTAC
GTAGCTATACC -> TAGCTATACCC
GTAGCTGTAAG -> TAGCTGTAAGT
GTAGGAGTTAT -> TAGGAGTTATG
GTAGGTCAAAT -> TAGGTCAAATA
GTAGTCGCTCC -> TAGTCGCTCCG
GTAGTTCAACA -> TAGTTCAACAC
GTATACTCATA -> TATACTCATAC
GTATAGTCATG -> TATAGTCATGA
GTATCGCTCCT -> TATCGCTCCTT
GTATCGTTGAT -> TATCGTTGATG
GTATGCCCATT -> TATGCCCATTA
GTATGCTCATG -> TATGCTCATGT
GTATTAGTCGC -> TATTAGTCGCT
GTATTGGCAAC -> TATTGGCAACT
GTCAAATATAA -> TCAAATATAAA
GTCAAATGGAC -> TCAAATGGACC
GTCACAGCCGA -> TCACAGCCGAA
GTCACCTCTAA -> TCACCTCTAAG
GTCACGACACC -> TCACGACACCT
GTCACGATCCG -> TCACGATCCGG
GTCACTACATG -> TCACTACATGC
GTCATCCAACG -> TCATCCAACGG
GTCATGAACCC -> TCATGAACCCG
GTCATTTCTAC -> TCATTTCTACT
GTCATTTGACC -> TCATTTGACCA
GTCCAAATGGG -> TCCAAATGGGA
GTCCATGTAAC -> TCCATGTAACG
GTCCCTAGTTA -> TCCCTAGTTAT
GTCCCTCTTGT -> TCCCTCTTGTG
GTCCGCCAGAT -> TCCGCCAGATT
GTCCGCTAATT -> TCCGCTAATTA
GTCCGTCAAAT -> TCCGTCAAATG
GTCCTAAATAG -> TCCTAAATAGC
GTCCTCCTCTT -> TCCTCCTCTTG
GTCCTGATTCG -> TCCTGATTCGA
GTCCTTGGTGA -> TCCTTGGTGAC
GTCGAAGTTTG -> TCGAAGTTTGG
GTCGATTGACG -> TCGATTGACGG
GTCGCACTGTG -> TCGCACTGTGA
GTCGCTAGGTA -> TCGCTAGGTAA
GTCGCTCCGGG -> TCGCTCCGGGC
GTCGGACCAGT -> TCGGACCAGTC
GTCGGGTTGGG -> TCGGGTTGGGT
GTCGTCACAGC -> TCGTCACAGCC
GTCGTCGTCGT -> TCGTCGTCGTT
GTCGTCGTTCG -> TCGTCGTTCGA
GTCGTTCGACT -> TCGTTCGACTT
GTCGTTTCTCG -> TCGTTTCTCGA
GTCTATCCCAA -> TCTATCCCAAA
GTCTCGCTGAT -> TCTCGCTGATA
GTCTGAATGAT -> TCTGAATGATC
GTCTTACAGTT -> TCTTACAGTTG
GTCTTACGAAT -> TCTTACGAATC
GTCTTGATGCG -> TCTTGATGCGA
GTGAACGTACG -> TGAACGTACGC
GTGAATGGAAC -> TGAATGGAACA
GTGACTCCTTT -> TGACTCCTTTA
GTGAGATCTGC -> TGAGATCTGCC
GTGAGGGCACG -> TGAGGGCACGG
GTGAGTATCGC -> TGAGTATCGCT
GTGAGTGCGTG -> TGAGTGCGTGA
GTGATCAGGTT -> TGATCAGGTTC
GTGATCTAAGC -> TGATCTAAGCC
GTGCATAGCCC -> TGCATAGCCCT
GTGCGACACTA -> TGCGACACTAA
GTGCGACCACA -> TGCGACCACAC
GTGCGCCCTGC -> TGCGCCCTGCC
GTGCGTGAGAT -> TGCGTGAGATC
GTGGAGGACCT -> TGGAGGACCTG
GTGGCCAGGCT -> TGGCCAGGCTT
GTGGCTTGAGG -> TGGCTTGAGGG
GTGGGCCTAAA -> TGGGCCTAAAC
GTGGTAATGAT -> TGGTAATGATA
GTGGTGATCAG -> TGGTGATCAGG
GTGTAACCTCG -> TGTAACCTCGA
GTGTAAGAAAC -> TGTAAGAAACC
GTGTACGGGCA -> TGTACGGGCAG
GTGTCGGGTTG -> TGTCGGGTTGG
GTGTGCGCCCT -> TGTGCGCCCTG
GTGTTGTGGTG -> TGTTGTGGTGA
GTTAACCTAAG -> TTAACCTAAGG
GTTAACGTGGC -> TTAACGTGGCT
GTTATAGGAGC -> TTATAGGAGCC
GTTATGGCACT -> TTATGGCACTA
GTTCAACACAT -> TTCAACACATA
GTTCGAACCAA -> TTCGAACCAAC
GTTCGACTTTA -> TTCGACTTTAA
GTTCGCAGACG -> TTCGCAGACGA
GTTCGGCTTCC -> TTCGGCTTCCC
GTTCGGTCCCT -> TTCGGTCCCTC
GTTGAGTAGCT -> TTGAGTAGCTG
GTTGATGATGC -> TTGATGATGCG
GTTGGGTTTAA -> TTGGGTTTAAA
GTTGTACAGAT -> TTGTACAGATT
GTTGTCACCTC -> TTGTCACCTCT
GTTGTCCATGT -> TTGTCCATGTA
GTTGTGGTGAT -> TTGTGGTGATC
GTTGTGTAAGA -> TTGTGTAAGAA
GTTTAAAAACA -> TTTAAAAACAT
GTTTCCCAATT -> TTTCCCAATTG
GTTTCTCGACC -> TTTCTCGACCC
GTTTCTTGGAG -> TTTCTTGGAGG
GTTTGCCCAGT -> TTTGCCCAGTA
GTTTGGCAGTA -> TTTGGCAGTAG
GTTTGGCCTAT -> TTTGGCCTATA
GTTTTGGATGA -> TTTTGGATGAT
TAAAAACATGG -> AAAAACATGGC
TAAAATATTAA -> AAAATATTAAT
TAAACACCGAT -> AAACACCGATG
TAAACTGAGGA -> AAACTGAGGAT
TAAACTGAGTG -> AAACTGAGTGG
TAAAGCATTAA -> AAAGCATTAAG
TAAAGCCTACT -> AAAGCCTACTG
TAAAGGCCATT -> AAAGGCCATTG
TAAATAGCGGT -> AAATAGCGGTC
TAAATCGGCGT -> AAATCGGCGTG
TAAATGTATCG -> AAATGTATCGT
TAAATTAAAGC -> AAATTAAAGCC
TAACAGATTCA -> AACAGATTCAG
TAACCTAAGGG -> AACCTAAGGGC
TAACCTCGATC -> AACCTCGATCC
TAACCTCTAGA -> AACCTCTAGAG
TAACGATCGCG -> AACGATCGCGT
TAACGCATCAT -> AACGCATCATC
TAACGGAATGC -> AACGGAATGCA
TAACGTGGCTT -> AACGTGGCTTG
TAAGAAACCTT -> AAGAAACCTTA
TAAGCCACTCT -> AAGCCACTCTG
TAAGCCGGTGT -> AAGCCGGTGTC
TAAGGAAATAA -> AAGGAAATAAT
TAAGGCTTGCG -> AAGGCTTGCGG
TAAGGGAAGTG -> AAGGGAAGTGG
TAAGGGCAGAC -> AAGGGCAGACG
TAAGTAGGTCA -> AAGTAGGTCAA
TAATAAGGGAA -> AATAAGGGAAG
TAATATGTCCT -> AATATGTCCTG
TAATATTGGTT -> AATATTGGTTA
TAATATTGTAT -> AATATTGTATG
TAATGAGTTTT -> AATGAGTTTTG
TAATGATAGCA -> AATGATAGCAG
TAATTAAATGT -> AATTAAATGTA
TAATTATAATA -> AATTATAATAT
TAATTCCTACT -> AATTCCTACTG
TAATTGTCTGA -> AATTGTCTGAA
TAATTTGTTGA -> AATTTGTTGAG
TACAACACTGC -> ACAACACTGCC
TACAACCGAAG -> ACAACCGAAGG
TACACGTTAAC -> ACACGTTAACG
TACAGATTGGG -> ACAGATTGGGC
TACAGTTGTAC -> ACAGTTGTACA
TACATGACTTC -> ACATGACTTCA
TACATGCCGGT -> ACATGCCGGTC
TACATTATCCA -> ACATTATCCAA
TACCATTCATA -> ACCATTCATAG
TACCCCTTCCT -> ACCCCTTCCTT
TACCCGAAGCG -> ACCCGAAGCGA
TACCCGTCGCA -> ACCCGTCGCAC
TACCGACAACC -> ACCGACAACCA
TACCGCGTAGT -> ACCGCGTAGTT
TACGAATCTAC -> ACGAATCTACG
TACGATCTCGC -> ACGATCTCGCT
TACGCAAGCGA -> ACGCAAGCGAA
TACGCCATGCG -> ACGCCATGCGC
TACGGGCAGGT -> ACGGGCAGGTA
TACGTCGTCGT -> ACGTCGTCGTC
TACTAGCACCA -> ACTAGCACCAA
TACTAGCTCAA -> ACTAGCTCAAG
TACTCATACCG -> ACTCATACCGA
TACTCCTAACA -> ACTCCTAACAG
TACTCTGGCCA -> ACTCTGGCCAC
TACTGGTCTAT -> ACTGGTCTATC
TACTGTGCGAC -> ACTGTGCGACA
TACTTCTCAAA -> ACTTCTCAAAT
TAGAACGATGC -> AGAACGATGCG
TAGAACTTTAA -> AGAACTTTAAA
TAGACAATTGT -> AGACAATTGTT
TAGACAGCTGT -> AGACAGCTGTT
TAGAGCGCGCT -> AGAGCGCGCTT
TAGATTAGACA -> AGATTAGACAG
TAGCACCAAGC -> AGCACCAAGCG
TAGCAGAGTCA -> AGCAGAGTCAC
TAGCCCTCCTC -> AGCCCTCCTCT
TAGCGGTCCGC -> AGCGGTCCGCC
TAGCGTCTTAC -> AGCGTCTTACA
TAGCTATACCC -> AGCTATACCCG
TAGCTCAAGGA -> AGCTCAAGGAC
TAGCTGTAAGT -> AGCTGTAAGTA
TAGGAATTGGT -> AGGAATTGGTG
TAGGAGCCTGG -> AGGAGCCTGGC
TAGGAGTTATG -> AGGAGTTATGG
TAGGGGTAGAA -> AGGGGTAGAAC
TAGGTAATTGT -> AGGTAATTGTC
TAGGTCAAATA -> AGGTCAAATAT
TAGGTCGGACC -> AGGTCGGACCA
TAGTATACTCA -> AGTATACTCAT
TAGTCATGAAC -> AGTCATGAACC
TAGTCCTTGGT -> AGTCCTTGGTG
TAGTCGCTAGG -> AGTCGCTAGGT
TAGTCGCTCCG -> AGTCGCTCCGG
TAGTCGTTTCT -> AGTCGTTTCTC
TAGTTATAGGA -> AGTTATAGGAG
TAGTTCAACAC -> AGTTCAACACA
TATAAAATATT -> ATAAAATATTA
TATAAAGCATT -> ATAAAGCATTA
TATAATATGTC -> ATAATATGTCC
TATACCCGTCG -> ATACCCGTCGC
TATACTCATAC -> ATACTCATACC
TATAGGAGCCT -> ATAGGAGCCTG
TATAGTCATGA -> ATAGTCATGAA
TATATCCCAAG -> ATATCCCAAGG
TATATCTAGGG -> ATATCTAGGGG
TATCCAACTGT -> ATCCAACTGTC
TATCCCAAAGC -> ATCCCAAAGCC
TATCCCAAGGT -> ATCCCAAGGTC
TATCCTACTCC -> ATCCTACTCCT
TATCGCTCCTT -> ATCGCTCCTTT
TATCGTTGATG -> ATCGTTGATGA
TATCTAGGGGT -> ATCTAGGGGTA
TATCTTGCTGG -> ATCTTGCTGGT
TATCTTTGGCA -> ATCTTTGGCAT
TATGACGTAAA -> ATGACGTAAAG
TATGCCCATTA -> ATGCCCATTAT
TATGCTCATGT -> ATGCTCATGTA
TATGGCACTAC -> ATGGCACTACA
TATGTCCTGAT -> ATGTCCTGATT
TATGTTGTCCA -> ATGTTGTCCAT
TATTAAATCGG -> ATTAAATCGGC
TATTAATTTGT -> ATTAATTTGTT
TATTAGGTCGG -> ATTAGGTCGGA
TATTAGTCGCT -> ATTAGTCGCTA
TATTGGCAACT -> ATTGGCAACTC
TATTGGTTAAC -> ATTGGTTAACC
TATTGTATGCC -> ATTGTATGCCC
TCAAATATAAA -> CAAATATAAAG
TCAAATCCGAA -> CAAATCCGAAC
TCAAATGGACC -> CAAATGGACCA
TCAACACATAA -> CAACACATAAC
TCAACCGATGT -> CAACCGATGTT
TCAAGGACATG -> CAAGGACATGG
TCACAGCCGAA -> CACAGCCGAAG
TCACCAGATAG -> CACCAGATAGA
TCACCCAATTG -> CACCCAATTGA
TCACCTCTAAG -> CACCTCTAAGG
TCACGACACCT -> CACGACACCTT
TCACGATCCGG -> CACGATCCGGT
TCACTACATGC -> CACTACATGCC
TCAGAGGCAGA -> CAGAGGCAGAC
TCAGAGGGTGG -> CAGAGGGTGGG
TCAGCTCCGAC -> CAGCTCCGACC
TCAGGTTCGGC -> CAGGTTCGGCT
TCAGTGAGGGC -> CAGTGAGGGCA
TCATACCGACA -> CATACCGACAA
TCATACGTCGT -> CATACGTCGTC
TCATAGTCGTT -> CATAGTCGTTT
TCATCCAACGG -> CATCCAACGGG
TCATCGCCAGT -> CATCGCCAGTA
TCATGAACCCG -> CATGAACCCGC
TCATGTAATAA -> CATGTAATAAG
TCATTGCCTCA -> CATTGCCTCAC
TCATTTCTACT -> CATTTCTACTC
TCATTTGACCA -> CATTTGACCAA
TCCAAATGGGA -> CCAAATGGGAT
TCCAACGGGAC -> CCAACGGGACT
TCCAACTGTCA -> CCAACTGTCAC
TCCAGAATTAC -> CCAGAATTACT
TCCATGTAACG -> CCATGTAACGA
TCCCAAAGCCG -> CCCAAAGCCGT
TCCCAAGGTCG -> CCCAAGGTCGA
TCCCAATTGAG -> CCCAATTGAGA
TCCCCCCGCAA -> CCCCCCGCAAG
TCCCCGCGAGT -> CCCCGCGAGTA
TCCCGGTTTGG -> CCCGGTTTGGC
TCCCTAGTTAT -> CCCTAGTTATA
TCCCTCTTGTG -> CCCTCTTGTGC
TCCCTTGTCAT -> CCCTTGTCATT
TCCGAACTACA -> CCGAACTACAT
TCCGACCGGCA -> CCGACCGGCAT
TCCGCCAGATT -> CCGCCAGATTC
TCCGCTAATTA -> CCGCTAATTAT
TCCGGGCCACA -> CCGGGCCACAA
TCCGGTTCGGT -> CCGGTTCGGTC
TCCGTCAAATG -> CCGTCAAATGG
TCCGTCCGCTA -> CCGTCCGCTAA
TCCTAAATAGC -> CCTAAATAGCG
TCCTAACAGAT -> CCTAACAGATT
TCCTACAACCG -> CCTACAACCGA
TCCTACTCCTA -> CCTACTCCTAA
TCCTACTGGTC -> CCTACTGGTCT
TCCTCCTCTTG -> CCTCCTCTTGG
TCCTCTGCGAC -> CCTCTGCGACC
TCCTCTTGGAC -> CCTCTTGGACA
TCCTGATTCGA -> CCTGATTCGAC
TCCTGGAAACA -> CCTGGAAACAC
TCCTGGAGGCA -> CCTGGAGGCAC
TCCTTCCTTGA -> CCTTCCTTGAC
TCCTTGACAGG -> CCTTGACAGGA
TCCTTGGCTCG -> CCTTGGCTCGA
TCCTTGGTGAC -> CCTTGGTGACT
TCCTTTAATGA -> CCTTTAATGAG
TCCTTTAGTAT -> CCTTTAGTATA
TCCTTTATTAA -> CCTTTATTAAA
TCCTTTTTCTT -> CCTTTTTCTTG
TCGAAAAACCT -> CGAAAAACCTC
TCGAACCAACA -> CGAACCAACAA
TCGAAGTTTGG -> CGAAGTTTGGC
TCGACAGTACC -> CGACAGTACCA
TCGACCCCGGC -> CGACCCCGGCT
TCGACTTTAAG -> CGACTTTAAGG
TCGATCCCCCC -> CGATCCCCCCG
TCGATTGACGG -> CGATTGACGGT
TCGCACTGTGA -> CGCACTGTGAA
TCGCAGACGAG -> CGCAGACGAGT
TCGCCAGTAAT -> CGCCAGTAATA
TCGCCAGTGGT -> CGCCAGTGGTA
TCGCCGTTTGC -> CGCCGTTTGCC
TCGCGTGAGTA -> CGCGTGAGTAT
TCGCTAACGGA -> CGCTAACGGAA
TCGCTAGGTAA -> CGCTAGGTAAT
TCGCTCCGGGC -> CGCTCCGGGCC
TCGCTCCTTTT -> CGCTCCTTTTT
TCGCTGATAAA -> CGCTGATAAAC
TCGGACCAGTC -> CGGACCAGTCT
TCGGAGCACTT -> CGGAGCACTTC
TCGGCGTGAAT -> CGGCGTGAATG
TCGGCTTCCCC -> CGGCTTCCCCG
TCGGGGAATAC -> CGGGGAATACG
TCGGGTTGGGT -> CGGGTTGGGTT
TCGGTCCCTCT -> CGGTCCCTCTT
TCGTACTTCTC -> CGTACTTCTCA
TCGTCACAGCC -> CGTCACAGCCG
TCGTCGTCGTT -> CGTCGTCGTTC
TCGTCGTTCGA -> CGTCGTTCGAC
TCGTTCGACTT -> CGTTCGACTTT
TCGTTGATGAT -> CGTTGATGATG
TCGTTTCTCGA -> CGTTTCTCGAC
TCTAAGCCGGT -> CTAAGCCGGTG
TCTAAGGCTTG -> CTAAGGCTTGC
TCTACGATCTC -> CTACGATCTCG
TCTACTCTGGC -> CTACTCTGGCC
TCTAGAGCGCG -> CTAGAGCGCGC
TCTAGGGGTAG -> CTAGGGGTAGA
TCTATATCCCA -> CTATATCCCAA
TCTATCCCAAA -> CTATCCCAAAG
TCTATCTTGCT -> CTATCTTGCTG
TCTATCTTTGG -> CTATCTTTGGC
TCTCAAATCCG -> CTCAAATCCGA
TCTCCCGGTTT -> CTCCCGGTTTG
TCTCGACCCCG -> CTCGACCCCGG
TCTCGCTAACG -> CTCGCTAACGG
TCTCGCTGATA -> CTCGCTGATAA
TCTCGGAGCAC -> CTCGGAGCACT
TCTCTATATCC -> CTCTATATCCC
TCTGAATGATC -> CTGAATGATCT
TCTGCCGAAGG -> CTGCCGAAGGC
TCTGCGACCTC -> CTGCGACCTCC
TCTGCTGCTAG -> CTGCTGCTAGG
TCTGGCCACGT -> CTGGCCACGTG
TCTTACAGTTG -> CTTACAGTTGT
TCTTACGAATC -> CTTACGAATCT
TCTTCCAGAAT -> CTTCCAGAATT
TCTTGATGCGA -> CTTGATGCGAT
TCTTGCTGGTC -> CTTGCTGGTCA
TCTTGGACACA -> CTTGGACACAT
TCTTGGAGGGG -> CTTGGAGGGGA
TCTTGTGCATA -> CTTGTGCATAG
TCTTGTTTCCC -> CTTGTTTCCCA
TCTTTGGCATG -> CTTTGGCATGG
TGAACCCGCAA -> GAACCCGCAAT
TGAACGTACGC -> GAACGTACGCC
TGAATGATCTC -> GAATGATCTCG
TGAATGGAACA -> GAATGGAACAG
TGACAGGACAA -> GACAGGACAAT
TGACCAACTAA -> GACCAACTAAT
TGACGGTCCTC -> GACGGTCCTCC
TGACGTAAAGG -> GACGTAAAGGC
TGACTCCTTTA -> GACTCCTTTAG
TGACTTCACCA -> GACTTCACCAG
TGAGAGCGCCA -> GAGAGCGCCAG
TGAGATCTGCC -> GAGATCTGCCG
TGAGATTGTCC -> GAGATTGTCCC
TGAGGATTTAC -> GAGGATTTACT
TGAGGGCACGG -> GAGGGCACGGC
TGAGGGTGTAA -> GAGGGTGTAAC
TGAGTAGCTGT -> GAGTAGCTGTA
TGAGTATCGCT -> GAGTATCGCTC
TGAGTGCGTGA -> GAGTGCGTGAG
TGAGTGGAGGA -> GAGTGGAGGAC
TGAGTTGTCAC -> GAGTTGTCACC
TGAGTTTTGGA -> GAGTTTTGGAT
TGATAAACTGA -> GATAAACTGAG
TGATAGCAGAG -> GATAGCAGAGT
TGATAGTCCTT -> GATAGTCCTTG
TGATCAGGTTC -> GATCAGGTTCG
TGATCATACGT -> GATCATACGTC
TGATCTAAGCC -> GATCTAAGCCG
TGATCTCGGAG -> GATCTCGGAGC
TGATCTCTATA -> GATCTCTATAT
TGATGATGCGA -> GATGATGCGAT
TGATGCGAGAA -> GATGCGAGAAA
TGATGCGATGC -> GATGCGATGCC
TGATGCGATGG -> GATGCGATGGT
TGATTCGACAG -> GATTCGACAGT
TGCAATCTTCC -> GCAATCTTCCA
TGCATACCGCG -> GCATACCGCGT
TGCATAGCCCT -> GCATAGCCCTC
TGCATATTAGG -> GCATATTAGGT
TGCATTCAACC -> GCATTCAACCG
TGCCAATCCTT -> GCCAATCCTTG
TGCCCAGTAAA -> GCCCAGTAAAC
TGCCCATTATC -> GCCCATTATCC
TGCCGAAGGCA -> GCCGAAGGCAT
TGCCGGTCTCG -> GCCGGTCTCGC
TGCCTCACCCA -> GCCTCACCCAA
TGCCTCGCCGT -> GCCTCGCCGTG
TGCCTGAGATT -> GCCTGAGATTG
TGCCTGTGCGA -> GCCTGTGCGAC
TGCGACACTAA -> GCGACACTAAC
TGCGACCACAC -> GCGACCACACT
TGCGACCTCCT -> GCGACCTCCTT
TGCGAGAAAGG -> GCGAGAAAGGA
TGCGATGCCTG -> GCGATGCCTGA
TGCGATGGTGT -> GCGATGGTGTT
TGCGCCCTGCC -> GCGCCCTGCCA
TGCGCGACTCC -> GCGCGACTCCT
TGCGCTCAGTG -> GCGCTCAGTGA
TGCGGGGTCGT -> GCGGGGTCGTC
TGCGTAGGAGT -> GCGTAGGAGTT
TGCGTGAGATC -> GCGTGAGATCT
TGCTAGGAATT -> GCTAGGAATTG
TGCTCATGTAA -> GCTCATGTAAT
TGCTCCTACAA -> GCTCCTACAAC
TGCTGCTAGGA -> GCTGCTAGGAA
TGCTGGTCACG -> GCTGGTCACGA
TGGAAACACTG -> GGAAACACTGA
TGGAACAGGTC -> GGAACAGGTCG
TGGACACATGC -> GGACACATGCA
TGGACCATGGC -> GGACCATGGCA
TGGAGGACCTG -> GGAGGACCTGT
TGGAGGCACGT -> GGAGGCACGTA
TGGAGGCGTAC -> GGAGGCGTACC
TGGAGGGGAAC -> GGAGGGGAACT
TGGATGATGCG -> GGATGATGCGA
TGGCAACTCTA -> GGCAACTCTAT
TGGCACTACAT -> GGCACTACATG
TGGCAGTAGTC -> GGCAGTAGTCG
TGGCATAATTA -> GGCATAATTAA
TGGCATGGCTG -> GGCATGGCTGG
TGGCCACGTGT -> GGCCACGTGTG
TGGCCAGGCTT -> GGCCAGGCTTC
TGGCCTATAAA -> GGCCTATAAAA
TGGCCTCGCCG -> GGCCTCGCCGT
TGGCTACAACA -> GGCTACAACAC
TGGCTCGAAAA -> GGCTCGAAAAA
TGGCTGGGCAT -> GGCTGGGCATA
TGGCTTGAGGG -> GGCTTGAGGGT
TGGGATTATGA -> GGGATTATGAC
TGGGCATACAC -> GGGCATACACG
TGGGCCTAAAC -> GGGCCTAAACT
TGGGCGTGTAC -> GGGCGTGTACG
TGGGTTTAAAA -> GGGTTTAAAAA
TGGTAATGATA -> GGTAATGATAG
TGGTCACGACA -> GGTCACGACAC
TGGTCTATCCC -> GGTCTATCCCA
TGGTGACTCCT -> GGTGACTCCTT
TGGTGATCAGG -> GGTGATCAGGT
TGGTGATCTAA -> GGTGATCTAAG
TGGTGTTGTGG -> GGTGTTGTGGT
TGGTTAACCTA -> GGTTAACCTAA
TGTAACCTCGA -> GTAACCTCGAT
TGTAACGATCG -> GTAACGATCGC
TGTAAGAAACC -> GTAAGAAACCT
TGTAAGTAGGT -> GTAAGTAGGTC
TGTAATAAGGG -> GTAATAAGGGA
TGTACAGATTG -> GTACAGATTGG
TGTACGGGCAG -> GTACGGGCAGG
TGTAGACAATT -> GTAGACAATTG
TGTATCGTTGA -> GTATCGTTGAT
TGTATGCCCAT -> GTATGCCCATT
TGTATGCTCAT -> GTATGCTCATG
TGTCACCTCTA -> GTCACCTCTAA
TGTCACGATCC -> GTCACGATCCG
TGTCATCCAAC -> GTCATCCAACG
TGTCATTTGAC -> GTCATTTGACC
TGTCCATGTAA -> GTCCATGTAAC
TGTCCCTAGTT -> GTCCCTAGTTA
TGTCCTGATTC -> GTCCTGATTCG
TGTCGGGTTGG -> GTCGGGTTGGG
TGTCTGAATGA -> GTCTGAATGAT
TGTGAACGTAC -> GTGAACGTACG
TGTGCATAGCC -> GTGCATAGCCC
TGTGCGACACT -> GTGCGACACTA
TGTGCGACCAC -> GTGCGACCACA
TGTGCGCCCTG -> GTGCGCCCTGC
TGTGGTGATCA -> GTGGTGATCAG
TGTGTAAGAAA -> GTGTAAGAAAC
TGTTCGAACCA -> GTTCGAACCAA
TGTTCGCAGAC -> GTTCGCAGACG
TGTTGAGTAGC -> GTTGAGTAGCT
TGTTGTCCATG -> GTTGTCCATGT
TGTTGTGGTGA -> GTTGTGGTGAT
TGTTTCCCAAT -> GTTTCCCAATT
TGTTTCTTGGA -> GTTTCTTGGAG
TTAAAAACATG -> TAAAAACATGG
TTAAAGCCTAC -> TAAAGCCTACT
TTAAATCGGCG -> TAAATCGGCGT
TTAAATGTATC -> TAAATGTATCG
TTAAATTAAAG -> TAAATTAAAGC
TTAACCTAAGG -> TAACCTAAGGG
TTAACGTGGCT -> TAACGTGGCTT
TTAAGCCACTC -> TAAGCCACTCT
TTAAGGAAATA -> TAAGGAAATAA
TTAATGAGTTT -> TAATGAGTTTT
TTAATTTGTTG -> TAATTTGTTGA
TTACAGTTGTA -> TACAGTTGTAC
TTACGAATCTA -> TACGAATCTAC
TTACTAGCACC -> TACTAGCACCA
TTACTAGCTCA -> TACTAGCTCAA
TTAGACAGCTG -> TAGACAGCTGT
TTAGGTCGGAC -> TAGGTCGGACC
TTAGTATACTC -> TAGTATACTCA
TTAGTCGCTAG -> TAGTCGCTAGG
TTATAATATGT -> TATAATATGTC
TTATAGGAGCC -> TATAGGAGCCT
TTATCCAACTG -> TATCCAACTGT
TTATCCTACTC -> TATCCTACTCC
TTATGACGTAA -> TATGACGTAAA
TTATGGCACTA -> TATGGCACTAC
TTATGTTGTCC -> TATGTTGTCCA
TTATTAAATCG -> TATTAAATCGG
TTCAACACATA -> TCAACACATAA
TTCAACCGATG -> TCAACCGATGT
TTCACCAGATA -> TCACCAGATAG
TTCAGAGGCAG -> TCAGAGGCAGA
TTCAGAGGGTG -> TCAGAGGGTGG
TTCAGCTCCGA -> TCAGCTCCGAC
TTCATAGTCGT -> TCATAGTCGTT
TTCCAGAATTA -> TCCAGAATTAC
TTCCCAATTGA -> TCCCAATTGAG
TTCCCCGCGAG -> TCCCCGCGAGT
TTCCTACTGGT -> TCCTACTGGTC
TTCCTTCCTTG -> TCCTTCCTTGA
TTCCTTGACAG -> TCCTTGACAGG
TTCGAACCAAC -> TCGAACCAACA
TTCGACAGTAC -> TCGACAGTACC
TTCGACTTTAA -> TCGACTTTAAG
TTCGCAGACGA -> TCGCAGACGAG
TTCGCCAGTGG -> TCGCCAGTGGT
TTCGGCTTCCC -> TCGGCTTCCCC
TTCGGGGAATA -> TCGGGGAATAC
TTCGGTCCCTC -> TCGGTCCCTCT
TTCGTACTTCT -> TCGTACTTCTC
TTCTACTCTGG -> TCTACTCTGGC
TTCTATCTTTG -> TCTATCTTTGG
TTCTCAAATCC -> TCTCAAATCCG
TTCTCCCGGTT -> TCTCCCGGTTT
TTCTCGACCCC -> TCTCGACCCCG
TTCTTGGAGGG -> TCTTGGAGGGG
TTCTTGTTTCC -> TCTTGTTTCCC
TTGACAGGACA -> TGACAGGACAA
TTGACCAACTA -> TGACCAACTAA
TTGACGGTCCT -> TGACGGTCCTC
TTGAGAGCGCC -> TGAGAGCGCCA
TTGAGGGTGTA -> TGAGGGTGTAA
TTGAGTAGCTG -> TGAGTAGCTGT
TTGATCATACG -> TGATCATACGT
TTGATGATGCG -> TGATGATGCGA
TTGATGCGATG -> TGATGCGATGG
TTGCCCAGTAA -> TGCCCAGTAAA
TTGCCTCACCC -> TGCCTCACCCA
TTGCGGGGTCG -> TGCGGGGTCGT
TTGCTGGTCAC -> TGCTGGTCACG
TTGGACACATG -> TGGACACATGC
TTGGAGGGGAA -> TGGAGGGGAAC
TTGGATGATGC -> TGGATGATGCG
TTGGCAACTCT -> TGGCAACTCTA
TTGGCAGTAGT -> TGGCAGTAGTC
TTGGCATGGCT -> TGGCATGGCTG
TTGGCCTATAA -> TGGCCTATAAA
TTGGCTCGAAA -> TGGCTCGAAAA
TTGGGCGTGTA -> TGGGCGTGTAC
TTGGGTTTAAA -> TGGGTTTAAAA
TTGGTGACTCC -> TGGTGACTCCT
TTGGTGATCTA -> TGGTGATCTAA
TTGGTTAACCT -> TGGTTAACCTA
TTGTACAGATT -> TGTACAGATTG
TTGTATGCCCA -> TGTATGCCCAT
TTGTATGCTCA -> TGTATGCTCAT
TTGTCACCTCT -> TGTCACCTCTA
TTGTCATTTGA -> TGTCATTTGAC
TTGTCCATGTA -> TGTCCATGTAA
TTGTCCCTAGT -> TGTCCCTAGTT
TTGTCTGAATG -> TGTCTGAATGA
TTGTGCATAGC -> TGTGCATAGCC
TTGTGGTGATC -> TGTGGTGATCA
TTGTGTAAGAA -> TGTGTAAGAAA
TTGTTCGCAGA -> TGTTCGCAGAC
TTGTTGAGTAG -> TGTTGAGTAGC
TTGTTTCCCAA -> TGTTTCCCAAT
TTTAAAAACAT -> TTAAAAACATG
TTTAAATTAAA -> TTAAATTAAAG
TTTAAGGAAAT -> TTAAGGAAATA
TTTAATGAGTT -> TTAATGAGTTT
TTTACTAGCAC -> TTACTAGCACC
TTTAGTATACT -> TTAGTATACTC
TTTATTAAATC -> TTATTAAATCG
TTTCCCAATTG -> TTCCCAATTGA
TTTCTACTCTG -> TTCTACTCTGG
TTTCTCGACCC -> TTCTCGACCCC
TTTCTTGGAGG -> TTCTTGGAGGG
TTTCTTGTTTC -> TTCTTGTTTCC
TTTGACCAACT -> TTGACCAACTA
TTTGCCCAGTA -> TTGCCCAGTAA
TTTGGATGATG -> TTGGATGATGC
TTTGGCAGTAG -> TTGGCAGTAGT
TTTGGCATGGC -> TTGGCATGGCT
TTTGGCCTATA -> TTGGCCTATAA
TTTGTTGAGTA -> TTGTTGAGTAG
TTTTCTTGTTT -> TTTCTTGTTTC
TTTTGGATGAT -> TTTGGATGATG
TTTTTCTTGTT -> TTTTCTTGTTT
