AAAACATCGTCCGAAAATG -> AAACATCGTCCGAAAATGA
AAAACCTTACAGTGAGTTT -> AAACCTTACAGTGAGTTTT
AAAAGGGTAGGTATGCGTG -> AAAGGGTAGGTATGCGTGT
AAAAGTAGCAGAGAGTGTT -> AAAGTAGCAGAGAGTGTTG
AAAATGACTATGACGGCAA -> AAATGACTATGACGGCAAT
AAAATGACTATGACGGCCG -> AAATGACTATGACGGCCGC
AAAATGACTATGACGGCGA -> AAATGACTATGACGGCGAG
AAAATGACTATGACGGCTG -> AAATGACTATGACGGCTGG
AAAATGTAGCCTTGTTAGG -> AAATGTAGCCTTGTTAGGA
AAACAATTAATTATCGCTT -> AACAATTAATTATCGCTTT
AAACACGCAGCCAGCCCGC -> AACACGCAGCCAGCCCGCC
AAACATCGTCCGAAAATGA -> AACATCGTCCGAAAATGAC
AAACCAGAACCGCACGACT -> AACCAGAACCGCACGACTC
AAACCCTGGAGGTGGCCAA -> AACCCTGGAGGTGGCCAAT
AAACCGGCCGTGCGGGGTA -> AACCGGCCGTGCGGGGTAG
AAACCTTACAGTGAGTTTT -> AACCTTACAGTGAGTTTTC
AAACGGGTCACTCGGATCA -> AACGGGTCACTCGGATCAC
AAACGTATCTGCTTTGGTT -> AACGTATCTGCTTTGGTTG
AAACTTCCCAAGGTACGGG -> AACTTCCCAAGGTACGGGT
AAAGAGCCTGGCACCCGAC -> AAGAGCCTGGCACCCGACC
AAAGAGGTGTATAACCCTG -> AAGAGGTGTATAACCCTGC
AAAGATGATTTTACCCTCG -> AAGATGATTTTACCCTCGG
AAAGCTGATGAAGGTATGG -> AAGCTGATGAAGGTATGGT
AAAGGGTAGGTATGCGTGT -> AAGGGTAGGTATGCGTGTA
AAAGTAGCAGAGAGTGTTG -> AAGTAGCAGAGAGTGTTGT
AAATCATCTTGGCTTGTAA -> AATCATCTTGGCTTGTAAA
AAATCTATTTGCTGCGACT -> AATCTATTTGCTGCGACTG
AAATGACTATGACGGCAAT -> AATGACTATGACGGCAATT
AAATGACTATGACGGCCGC -> AATGACTATGACGGCCGCG
AAATGACTATGACGGCGAG -> AATGACTATGACGGCGAGT
AAATGACTATGACGGCTGG -> AATGACTATGACGGCTGGC
AAATGCCCGCGTTCTCAAG -> AATGCCCGCGTTCTCAAGT
AAATGCCGAGCCCTTGTTA -> AATGCCGAGCCCTTGTTAT
AAATGTAGCCTTGTTAGGA -> AATGTAGCCTTGTTAGGAA
AAATTAGCTTCTCTAAACC -> AATTAGCTTCTCTAAACCC
AACAATGGAAGGGGCCGAC -> ACAATGGAAGGGGCCGACG
AACAATTAATTATCGCTTT -> ACAATTAATTATCGCTTTA
AACACACAGGATGCCGGTT -> ACACACAGGATGCCGGTTA
AACACGCAGCCAGCCCGCC -> ACACGCAGCCAGCCCGCCA
AACACGTCTGATCAAGTGG -> ACACGTCTGATCAAGTGGA
AACATCGTCCGAAAATGAC -> ACATCGTCCGAAAATGACT
AACCAAACACGCAGCCAGC -> ACCAAACACGCAGCCAGCC
AACCAGAACCGCACGACTC -> ACCAGAACCGCACGACTCT
AACCATCTAAATCTATTTG -> ACCATCTAAATCTATTTGC
AACCATGGTGCAATCGCCA -> ACCATGGTGCAATCGCCAG
AACCCTGCAATTCAAATGC -> ACCCTGCAATTCAAATGCC
AACCCTGCATGACGGAAAC -> ACCCTGCATGACGGAAACT
AACCCTGGAGGTGGCCAAT -> ACCCTGGAGGTGGCCAATC
AACCGCACGACTCTGCAAA -> ACCGCACGACTCTGCAAAA
AACCGCCCGGCACTCCCAT -> ACCGCCCGGCACTCCCATG
AACCGCTGGCAAGGTTTGT -> ACCGCTGGCAAGGTTTGTT
AACCGGCCGTGCGGGGTAG -> ACCGGCCGTGCGGGGTAGA
AACCGTCATAGATCTCGAC -> ACCGTCATAGATCTCGACT
AACCTAACCATCTAAATCT -> ACCTAACCATCTAAATCTA
AACCTCTCTACGAAATTAG -> ACCTCTCTACGAAATTAGC
AACCTTACAGTGAGTTTTC -> ACCTTACAGTGAGTTTTCG
AACGAGGACGTGGTCATCG -> ACGAGGACGTGGTCATCGG
AACGCAAGTGTGAGCCTCG -> ACGCAAGTGTGAGCCTCGT
AACGGGACACTTTAAAGAT -> ACGGGACACTTTAAAGATG
AACGGGTCACTCGGATCAC -> ACGGGTCACTCGGATCACT
AACGTAGGTCATGGAAAAT -> ACGTAGGTCATGGAAAATG
AACGTATCTGCTTTGGTTG -> ACGTATCTGCTTTGGTTGC
AACGTCTAACTCTAGATGT -> ACGTCTAACTCTAGATGTT
AACTCATACGCACGTCTGA -> ACTCATACGCACGTCTGAT
AACTCTAGATGTTTCTCAT -> ACTCTAGATGTTTCTCATA
AACTGACCGGAGGAACACA -> ACTGACCGGAGGAACACAC
AACTGCCTTATTGCCACGA -> ACTGCCTTATTGCCACGAA
AACTTCACACGCAAGACCA -> ACTTCACACGCAAGACCAA
AACTTCCCAAGGTACGGGT -> ACTTCCCAAGGTACGGGTA
AAGAAACCAGAACCGCACG -> AGAAACCAGAACCGCACGA
AAGAAACGGGTCACTCGGA -> AGAAACGGGTCACTCGGAT
AAGAATCATATTGCCCGGT -> AGAATCATATTGCCCGGTT
AAGACCAAGAAACGGGTCA -> AGACCAAGAAACGGGTCAC
AAGACTAACTTCACACGCA -> AGACTAACTTCACACGCAA
AAGAGCCTGGCACCCGACC -> AGAGCCTGGCACCCGACCA
AAGAGGGTATTCATTTCAG -> AGAGGGTATTCATTTCAGA
AAGAGGGTTTCCTCTCTTT -> AGAGGGTTTCCTCTCTTTG
AAGAGGTGTATAACCCTGC -> AGAGGTGTATAACCCTGCA
AAGATGATTTTACCCTCGG -> AGATGATTTTACCCTCGGC
AAGATGCACGTTCGAGGCT -> AGATGCACGTTCGAGGCTC
AAGCCCCTGGCAATAGAAA -> AGCCCCTGGCAATAGAAAC
AAGCCCGTCGATAGGGTTT -> AGCCCGTCGATAGGGTTTG
AAGCTGATGAAGGTATGGT -> AGCTGATGAAGGTATGGTA
AAGGACGTTTGTCAACTCA -> AGGACGTTTGTCAACTCAT
AAGGCGATCCCGCCGTCAG -> AGGCGATCCCGCCGTCAGC
AAGGCGTTAACCATGGTGC -> AGGCGTTAACCATGGTGCA
AAGGCTTGACGCATTTGCG -> AGGCTTGACGCATTTGCGT
AAGGGAGTATCAGTGGCAA -> AGGGAGTATCAGTGGCAAC
AAGGGGCCGACGCACACAA -> AGGGGCCGACGCACACAAT
AAGGGTACGCTACGCGATA -> AGGGTACGCTACGCGATAG
AAGGGTAGGTATGCGTGTA -> AGGGTAGGTATGCGTGTAC
AAGGTACGGGTATATTAGA -> AGGTACGGGTATATTAGAC
AAGGTATGGTAGTATGGAG -> AGGTATGGTAGTATGGAGA
AAGGTTCTAGACTGTTCTG -> AGGTTCTAGACTGTTCTGC
AAGGTTTGTTTATCTGGCA -> AGGTTTGTTTATCTGGCAA
AAGTAGCAGAGAGTGTTGT -> AGTAGCAGAGAGTGTTGTA
AAGTCCCGACCCGTGCCGC -> AGTCCCGACCCGTGCCGCC
AAGTCTGCTATTGAAAGCT -> AGTCTGCTATTGAAAGCTG
AAGTGGACCAAGGTTCTAG -> AGTGGACCAAGGTTCTAGA
AAGTGGAGGACCCTACGCG -> AGTGGAGGACCCTACGCGC
AAGTGTATCTGGCGGATAC -> AGTGTATCTGGCGGATACT
AAGTGTGAGCCTCGTACTT -> AGTGTGAGCCTCGTACTTA
AATAAAAGTAGCAGAGAGT -> ATAAAAGTAGCAGAGAGTG
AATACAACCGCTGGCAAGG -> ATACAACCGCTGGCAAGGT
AATACCTCCGTTCCACAGG -> ATACCTCCGTTCCACAGGC
AATAGAAACCGGCCGTGCG -> ATAGAAACCGGCCGTGCGG
AATAGGCAATGCCGACCCA -> ATAGGCAATGCCGACCCAG
AATATCACTACAGAAAATG -> ATATCACTACAGAAAATGA
AATCACTTCATTTCGCTTT -> ATCACTTCATTTCGCTTTG
AATCATATTGCCCGGTTAC -> ATCATATTGCCCGGTTACA
AATCATCTTGGCTTGTAAA -> ATCATCTTGGCTTGTAAAG
AATCCTCTATGACTCAGAA -> ATCCTCTATGACTCAGAAT
AATCCTTAATAAAAGTAGC -> ATCCTTAATAAAAGTAGCA
AATCCTTCCCGCATCTCAG -> ATCCTTCCCGCATCTCAGC
AATCGCCAGGCTCGTGGAA -> ATCGCCAGGCTCGTGGAAT
AATCGGGTCCCAGAGATGA -> ATCGGGTCCCAGAGATGAG
AATCTATTTGCTGCGACTG -> ATCTATTTGCTGCGACTGC
AATGACTATGACGGCAATT -> ATGACTATGACGGCAATTC
AATGACTATGACGGCCGCG -> ATGACTATGACGGCCGCGT
AATGACTATGACGGCGAGT -> ATGACTATGACGGCGAGTC
AATGACTATGACGGCTGGC -> ATGACTATGACGGCTGGCG
AATGCCCGCGTTCTCAAGT -> ATGCCCGCGTTCTCAAGTC
AATGCCGACCCAGCTTAAT -> ATGCCGACCCAGCTTAATC
AATGCCGAGCCCTTGTTAT -> ATGCCGAGCCCTTGTTATA
AATGCTTGAAGGCGTTAAC -> ATGCTTGAAGGCGTTAACC
AATGGAAGGGGCCGACGCA -> ATGGAAGGGGCCGACGCAC
AATGTAATTGGTGAGACGC -> ATGTAATTGGTGAGACGCT
AATGTAGCCTTGTTAGGAA -> ATGTAGCCTTGTTAGGAAG
AATTAATTATCGCTTTACT -> ATTAATTATCGCTTTACTG
AATTAGCTTCTCTAAACCC -> ATTAGCTTCTCTAAACCCT
AATTAGGGCGGGGGTTGGG -> ATTAGGGCGGGGGTTGGGC
AATTATCGCTTTACTGAAA -> ATTATCGCTTTACTGAAAA
AATTCAAATGCCCGCGTTC -> ATTCAAATGCCCGCGTTCT
AATTCCCAACGAGGACGTG -> ATTCCCAACGAGGACGTGG
AATTGGTGAGACGCTATTT -> ATTGGTGAGACGCTATTTC
AATTTAACGGGACACTTTA -> ATTTAACGGGACACTTTAA
AATTTAAGAAACCAGAACC -> ATTTAAGAAACCAGAACCG
AATTTACTCACTATATCCT -> ATTTACTCACTATATCCTG
ACAAAAGGGTAGGTATGCG -> CAAAAGGGTAGGTATGCGT
ACAAAGAGCCTGGCACCCG -> CAAAGAGCCTGGCACCCGA
ACAACCAAACACGCAGCCA -> CAACCAAACACGCAGCCAG
ACAACCGCTGGCAAGGTTT -> CAACCGCTGGCAAGGTTTG
ACAACGTCTAACTCTAGAT -> CAACGTCTAACTCTAGATG
ACAAGATGCACGTTCGAGG -> CAAGATGCACGTTCGAGGC
ACAATGGAAGGGGCCGACG -> CAATGGAAGGGGCCGACGC
ACAATTAATTATCGCTTTA -> CAATTAATTATCGCTTTAC
ACAATTTAACGGGACACTT -> CAATTTAACGGGACACTTT
ACACAAAAGGGTAGGTATG -> CACAAAAGGGTAGGTATGC
ACACAATTTAACGGGACAC -> CACAATTTAACGGGACACT
ACACACAGGATGCCGGTTA -> CACACAGGATGCCGGTTAG
ACACAGGATGCCGGTTAGT -> CACAGGATGCCGGTTAGTC
ACACATCTGAGCCAGTTTC -> CACATCTGAGCCAGTTTCG
ACACCAGTACCGCTCGACA -> CACCAGTACCGCTCGACAA
ACACCCCTCTTTGGATTCT -> CACCCCTCTTTGGATTCTC
ACACGCAAGACCAAGAAAC -> CACGCAAGACCAAGAAACG
ACACGCAGCCAGCCCGCCA -> CACGCAGCCAGCCCGCCAA
ACACGTCTGATCAAGTGGA -> CACGTCTGATCAAGTGGAG
ACACTATACGGGTTCCATG -> CACTATACGGGTTCCATGC
ACACTCTCTCTTGAACACG -> CACTCTCTCTTGAACACGT
ACACTTTAAAGATGATTTT -> CACTTTAAAGATGATTTTA
ACAGAAAATGACTATGACG -> CAGAAAATGACTATGACGG
ACAGATGCAAGGACGTTTG -> CAGATGCAAGGACGTTTGT
ACAGGACGTGGTCATCGGA -> CAGGACGTGGTCATCGGAC
ACAGGATGCCGGTTAGTCG -> CAGGATGCCGGTTAGTCGC
ACAGGCATTTGTCTCGGTT -> CAGGCATTTGTCTCGGTTA
ACAGGCTATCTCAACGTAG -> CAGGCTATCTCAACGTAGG
ACAGTGAGTTTTCGTGACA -> CAGTGAGTTTTCGTGACAG
ACAGTGCGCTCTGCGGGGG -> CAGTGCGCTCTGCGGGGGA
ACAGTGGGATGTGTTCACG -> CAGTGGGATGTGTTCACGC
ACAGTTATGCGATCCACCT -> CAGTTATGCGATCCACCTT
ACATCGTCCGAAAATGACT -> CATCGTCCGAAAATGACTA
ACATCTGAGCCAGTTTCGA -> CATCTGAGCCAGTTTCGAC
ACCAAACACGCAGCCAGCC -> CCAAACACGCAGCCAGCCC
ACCAAGAAACGGGTCACTC -> CCAAGAAACGGGTCACTCG
ACCAAGGTTCTAGACTGTT -> CCAAGGTTCTAGACTGTTC
ACCAGAACCGCACGACTCT -> CCAGAACCGCACGACTCTG
ACCAGGGTTACGGCAGACT -> CCAGGGTTACGGCAGACTT
ACCAGTACCGCTCGACAAA -> CCAGTACCGCTCGACAAAG
ACCATCTAAATCTATTTGC -> CCATCTAAATCTATTTGCT
ACCATGGTGCAATCGCCAG -> CCATGGTGCAATCGCCAGG
ACCCAGCTTAATCACTTCA -> CCCAGCTTAATCACTTCAT
ACCCCTCTTTGGATTCTCA -> CCCCTCTTTGGATTCTCAG
ACCCGACCAGGGTTACGGC -> CCCGACCAGGGTTACGGCA
ACCCGTGCCGCCCTCGAGG -> CCCGTGCCGCCCTCGAGGG
ACCCTACGCGCTGTGGTCG -> CCCTACGCGCTGTGGTCGG
ACCCTCGGCCTGTCTAGAG -> CCCTCGGCCTGTCTAGAGG
ACCCTGCAATTCAAATGCC -> CCCTGCAATTCAAATGCCC
ACCCTGCATGACGGAAACT -> CCCTGCATGACGGAAACTT
ACCCTGGAGGTGGCCAATC -> CCCTGGAGGTGGCCAATCG
ACCGCACGACTCTGCAAAA -> CCGCACGACTCTGCAAAAC
ACCGCCCGGCACTCCCATG -> CCGCCCGGCACTCCCATGC
ACCGCGGTTCCATGATAAC -> CCGCGGTTCCATGATAACG
ACCGCTCGACAAAGAGCCT -> CCGCTCGACAAAGAGCCTG
ACCGCTGGCAAGGTTTGTT -> CCGCTGGCAAGGTTTGTTT
ACCGGAGGAACACACAGGA -> CCGGAGGAACACACAGGAT
ACCGGCCGTGCGGGGTAGA -> CCGGCCGTGCGGGGTAGAG
ACCGTCATAGATCTCGACT -> CCGTCATAGATCTCGACTC
ACCTAACCATCTAAATCTA -> CCTAACCATCTAAATCTAT
ACCTATCGCGTACTATAGC -> CCTATCGCGTACTATAGCT
ACCTCCGTTCCACAGGCAT -> CCTCCGTTCCACAGGCATT
ACCTCTCTACGAAATTAGC -> CCTCTCTACGAAATTAGCT
ACCTTAATCCTCTATGACT -> CCTTAATCCTCTATGACTC
ACCTTACAGTGAGTTTTCG -> CCTTACAGTGAGTTTTCGT
ACCTTGACGGTAAGGCGAT -> CCTTGACGGTAAGGCGATC
ACGAAATTAGCTTCTCTAA -> CGAAATTAGCTTCTCTAAA
ACGAAGACTAACTTCACAC -> CGAAGACTAACTTCACACG
ACGACTCTGCAAAACATCG -> CGACTCTGCAAAACATCGT
ACGAGGACGTGGTCATCGG -> CGAGGACGTGGTCATCGGA
ACGCAACCGCCCGGCACTC -> CGCAACCGCCCGGCACTCC
ACGCAAGACCAAGAAACGG -> CGCAAGACCAAGAAACGGG
ACGCAAGTGTGAGCCTCGT -> CGCAAGTGTGAGCCTCGTA
ACGCACACAATTTAACGGG -> CGCACACAATTTAACGGGA
ACGCACGTCTGATGAATAT -> CGCACGTCTGATGAATATC
ACGCAGCCAGCCCGCCAAA -> CGCAGCCAGCCCGCCAAAC
ACGCATTTGCGTGCCAAGT -> CGCATTTGCGTGCCAAGTC
ACGCGATAGCTACTTCAGA -> CGCGATAGCTACTTCAGAG
ACGCGCTGTGGTCGGAGGC -> CGCGCTGTGGTCGGAGGCC
ACGCTACGCGATAGCTACT -> CGCTACGCGATAGCTACTT
ACGCTATTTCCAATACCTC -> CGCTATTTCCAATACCTCC
ACGGAAACTTCCCAAGGTA -> CGGAAACTTCCCAAGGTAC
ACGGCAATTCCCAACGAGG -> CGGCAATTCCCAACGAGGA
ACGGCAGACTTTACAACGT -> CGGCAGACTTTACAACGTC
ACGGCCGCGTTGGGATAGG -> CGGCCGCGTTGGGATAGGA
ACGGCGAGTCGTGTACAGG -> CGGCGAGTCGTGTACAGGA
ACGGCTGGCGAGACGTAGG -> CGGCTGGCGAGACGTAGGA
ACGGGACACTTTAAAGATG -> CGGGACACTTTAAAGATGA
ACGGGTATATTAGACTCTA -> CGGGTATATTAGACTCTAT
ACGGGTCACTCGGATCACT -> CGGGTCACTCGGATCACTA
ACGGGTTCCATGCGTTTCT -> CGGGTTCCATGCGTTTCTG
ACGGTAAGGCGATCCCGCC -> CGGTAAGGCGATCCCGCCG
ACGTAGGACGTGGTCATCG -> CGTAGGACGTGGTCATCGG
ACGTAGGTCATGGAAAATG -> CGTAGGTCATGGAAAATGT
ACGTATCTGCTTTGGTTGC -> CGTATCTGCTTTGGTTGCC
ACGTCTAACTCTAGATGTT -> CGTCTAACTCTAGATGTTT
ACGTCTGATCAAGTGGAGG -> CGTCTGATCAAGTGGAGGA
ACGTCTGATGAATATCACT -> CGTCTGATGAATATCACTA
ACGTGGTCATCGGACAACC -> CGTGGTCATCGGACAACCA
ACGTGGTCATCGGACACCA -> CGTGGTCATCGGACACCAG
ACGTGGTCATCGGACAGGC -> CGTGGTCATCGGACAGGCT
ACGTGGTCATCGGACAGTG -> CGTGGTCATCGGACAGTGC
ACGTGGTGATGAGGATTTC -> CGTGGTGATGAGGATTTCC
ACGTTCGAGGCTCTTTTTT -> CGTTCGAGGCTCTTTTTTA
ACGTTGCAGTGAGGCCAAG -> CGTTGCAGTGAGGCCAAGG
ACGTTTGTCAACTCATACG -> CGTTTGTCAACTCATACGC
ACTAACTTCACACGCAAGA -> CTAACTTCACACGCAAGAC
ACTACAGAAAATGACTATG -> CTACAGAAAATGACTATGA
ACTACCGCGGTTCCATGAT -> CTACCGCGGTTCCATGATA
ACTATACGGGTTCCATGCG -> CTATACGGGTTCCATGCGT
ACTATAGCTGTGCACACAT -> CTATAGCTGTGCACACATC
ACTATATCCTGCTAATCCT -> CTATATCCTGCTAATCCTT
ACTATATTCTATGCAATAG -> CTATATTCTATGCAATAGG
ACTATGACGGCAATTCCCA -> CTATGACGGCAATTCCCAA
ACTATGACGGCCGCGTTGG -> CTATGACGGCCGCGTTGGG
ACTATGACGGCGAGTCGTG -> CTATGACGGCGAGTCGTGT
ACTATGACGGCTGGCGAGA -> CTATGACGGCTGGCGAGAC
ACTCACTATATCCTGCTAA -> CTCACTATATCCTGCTAAT
ACTCAGAATTTAAGAAACC -> CTCAGAATTTAAGAAACCA
ACTCATACGCACGTCTGAT -> CTCATACGCACGTCTGATG
ACTCCCATGCCCCCGCACG -> CTCCCATGCCCCCGCACGT
ACTCCGCGTATTAGAAGTG -> CTCCGCGTATTAGAAGTGT
ACTCGGATCACTACCGCGG -> CTCGGATCACTACCGCGGT
ACTCTAGATGTTTCTCATA -> CTCTAGATGTTTCTCATAG
ACTCTATCCCTTTAATCCT -> CTCTATCCCTTTAATCCTT
ACTCTCAGATGCCATCTGG -> CTCTCAGATGCCATCTGGA
ACTCTCTCTTGAACACGTC -> CTCTCTCTTGAACACGTCT
ACTCTGCAAAACATCGTCC -> CTCTGCAAAACATCGTCCG
ACTGAAAATGACTATGACG -> CTGAAAATGACTATGACGG
ACTGACCGGAGGAACACAC -> CTGACCGGAGGAACACACA
ACTGATTCGCAGCTTCCCG -> CTGATTCGCAGCTTCCCGG
ACTGCCTTATTGCCACGAA -> CTGCCTTATTGCCACGAAG
ACTGTTCTGCCACTTGTGG -> CTGTTCTGCCACTTGTGGT
ACTTAACAATGGAAGGGGC -> CTTAACAATGGAAGGGGCC
ACTTACTCCGCGTATTAGA -> CTTACTCCGCGTATTAGAA
ACTTATCCTGATCTAAGGC -> CTTATCCTGATCTAAGGCT
ACTTCACACGCAAGACCAA -> CTTCACACGCAAGACCAAG
ACTTCAGAGTAGACTTATC -> CTTCAGAGTAGACTTATCC
ACTTCATTTCGCTTTGACA -> CTTCATTTCGCTTTGACAG
ACTTCCCAAGGTACGGGTA -> CTTCCCAAGGTACGGGTAT
ACTTGTGGTGTCAATTAGG -> CTTGTGGTGTCAATTAGGG
ACTTTAAAGATGATTTTAC -> CTTTAAAGATGATTTTACC
ACTTTACAACGTCTAACTC -> CTTTACAACGTCTAACTCT
AGAAAATGACTATGACGGC -> GAAAATGACTATGACGGCA
AGAAACCAGAACCGCACGA -> GAAACCAGAACCGCACGAC
AGAAACCGGCCGTGCGGGG -> GAAACCGGCCGTGCGGGGT
AGAAACGGGTCACTCGGAT -> GAAACGGGTCACTCGGATC
AGAACCGCACGACTCTGCA -> GAACCGCACGACTCTGCAA
AGAAGTGTATCTGGCGGAT -> GAAGTGTATCTGGCGGATA
AGAATCATATTGCCCGGTT -> GAATCATATTGCCCGGTTA
AGAATTTAAGAAACCAGAA -> GAATTTAAGAAACCAGAAC
AGACACTATACGGGTTCCA -> GACACTATACGGGTTCCAT
AGACCAAGAAACGGGTCAC -> GACCAAGAAACGGGTCACT
AGACGCTATTTCCAATACC -> GACGCTATTTCCAATACCT
AGACGTAGGACGTGGTCAT -> GACGTAGGACGTGGTCATC
AGACTAACTTCACACGCAA -> GACTAACTTCACACGCAAG
AGACTCTATCCCTTTAATC -> GACTCTATCCCTTTAATCC
AGACTGTTCTGCCACTTGT -> GACTGTTCTGCCACTTGTG
AGACTTATCCTGATCTAAG -> GACTTATCCTGATCTAAGG
AGACTTTACAACGTCTAAC -> GACTTTACAACGTCTAACT
AGAGAGTGTTGTATGGACA -> GAGAGTGTTGTATGGACAC
AGAGATGAGTTCCAAATCA -> GAGATGAGTTCCAAATCAT
AGAGATTGGCTTCAACCCT -> GAGATTGGCTTCAACCCTG
AGAGCCAATGCTTGAAGGC -> GAGCCAATGCTTGAAGGCG
AGAGCCTGGCACCCGACCA -> GAGCCTGGCACCCGACCAG
AGAGCGCGTCGTAAAACCT -> GAGCGCGTCGTAAAACCTT
AGAGGAAATGCCGAGCCCT -> GAGGAAATGCCGAGCCCTT
AGAGGATGGGTCCGAACTG -> GAGGATGGGTCCGAACTGC
AGAGGGTATTCATTTCAGA -> GAGGGTATTCATTTCAGAC
AGAGGGTTTCCTCTCTTTG -> GAGGGTTTCCTCTCTTTGG
AGAGGTGTATAACCCTGCA -> GAGGTGTATAACCCTGCAA
AGAGTAGACTTATCCTGAT -> GAGTAGACTTATCCTGATC
AGAGTGTTGTATGGACACT -> GAGTGTTGTATGGACACTC
AGATAGCAGAGATTGGCTT -> GATAGCAGAGATTGGCTTC
AGATCTCGACTCTCAGATG -> GATCTCGACTCTCAGATGC
AGATGAGTTCCAAATCATC -> GATGAGTTCCAAATCATCT
AGATGATTTTACCCTCGGC -> GATGATTTTACCCTCGGCC
AGATGCAAGGACGTTTGTC -> GATGCAAGGACGTTTGTCA
AGATGCACGTTCGAGGCTC -> GATGCACGTTCGAGGCTCT
AGATGCCATCTGGACGTGG -> GATGCCATCTGGACGTGGT
AGATGGTATACTATATTCT -> GATGGTATACTATATTCTA
AGATGTTTCTCATAGAGCC -> GATGTTTCTCATAGAGCCA
AGATTGGCTTCAACCCTGC -> GATTGGCTTCAACCCTGCA
AGCAGAGAGTGTTGTATGG -> GCAGAGAGTGTTGTATGGA
AGCAGAGATTGGCTTCAAC -> GCAGAGATTGGCTTCAACC
AGCAGAGGATGGGTCCGAA -> GCAGAGGATGGGTCCGAAC
AGCCAACCTAACCATCTAA -> GCCAACCTAACCATCTAAA
AGCCAATGCTTGAAGGCGT -> GCCAATGCTTGAAGGCGTT
AGCCAGCCCGCCAAACGTA -> GCCAGCCCGCCAAACGTAT
AGCCAGTTTCGACTGATTC -> GCCAGTTTCGACTGATTCG
AGCCCCTGGCAATAGAAAC -> GCCCCTGGCAATAGAAACC
AGCCCGCCAAACGTATCTG -> GCCCGCCAAACGTATCTGC
AGCCCGTCGATAGGGTTTG -> GCCCGTCGATAGGGTTTGC
AGCCCTTGTTATACCTTAA -> GCCCTTGTTATACCTTAAT
AGCCTCGTACTTACTCCGC -> GCCTCGTACTTACTCCGCG
AGCCTGGCACCCGACCAGG -> GCCTGGCACCCGACCAGGG
AGCCTTGTTAGGAAGAATC -> GCCTTGTTAGGAAGAATCA
AGCGCAAGAGGGTATTCAT -> GCGCAAGAGGGTATTCATT
AGCGCAAGGGTACGCTACG -> GCGCAAGGGTACGCTACGC
AGCGCGTCGTAAAACCTTA -> GCGCGTCGTAAAACCTTAC
AGCTACTTCAGAGTAGACT -> GCTACTTCAGAGTAGACTT
AGCTGATGAAGGTATGGTA -> GCTGATGAAGGTATGGTAG
AGCTGTGCACACATCTGAG -> GCTGTGCACACATCTGAGC
AGCTTAATCACTTCATTTC -> GCTTAATCACTTCATTTCG
AGCTTCCCGGCGGAAAATG -> GCTTCCCGGCGGAAAATGA
AGCTTCTCTAAACCCTGGA -> GCTTCTCTAAACCCTGGAG
AGGAAATGCCGAGCCCTTG -> GGAAATGCCGAGCCCTTGT
AGGAACACACAGGATGCCG -> GGAACACACAGGATGCCGG
AGGAAGAATCATATTGCCC -> GGAAGAATCATATTGCCCG
AGGAAGCCCCTGGCAATAG -> GGAAGCCCCTGGCAATAGA
AGGACCCTACGCGCTGTGG -> GGACCCTACGCGCTGTGGT
AGGACGTGGTCATCGGACA -> GGACGTGGTCATCGGACAA,GGACGTGGTCATCGGACAC,GGACGTGGTCATCGGACAG,GGACGTGGTCATCGGACAG
AGGACGTTTGTCAACTCAT -> GGACGTTTGTCAACTCATA
AGGATGCCGGTTAGTCGCG -> GGATGCCGGTTAGTCGCGC
AGGATGGGTCCGAACTGCC -> GGATGGGTCCGAACTGCCT
AGGATTTCCTGGGCTAACC -> GGATTTCCTGGGCTAACCT
AGGCAATGCCGACCCAGCT -> GGCAATGCCGACCCAGCTT
AGGCATTTGTCTCGGTTAG -> GGCATTTGTCTCGGTTAGA
AGGCCAAGGGAGTATCAGT -> GGCCAAGGGAGTATCAGTG
AGGCCGCCGACACAAAAGG -> GGCCGCCGACACAAAAGGG
AGGCGAATACAACCGCTGG -> GGCGAATACAACCGCTGGC
AGGCGATCCCGCCGTCAGC -> GGCGATCCCGCCGTCAGCG
AGGCGTTAACCATGGTGCA -> GGCGTTAACCATGGTGCAA
AGGCTATCTCAACGTAGGT -> GGCTATCTCAACGTAGGTC
AGGCTCGTGGAATGTAATT -> GGCTCGTGGAATGTAATTG
AGGCTCTTTTTTAGCGCAA -> GGCTCTTTTTTAGCGCAAG
AGGCTTGACGCATTTGCGT -> GGCTTGACGCATTTGCGTG
AGGGACAAGATGCACGTTC -> GGGACAAGATGCACGTTCG
AGGGAGTATCAGTGGCAAC -> GGGAGTATCAGTGGCAACC
AGGGCGGGGGTTGGGCATG -> GGGCGGGGGTTGGGCATGG
AGGGGCCGACGCACACAAT -> GGGGCCGACGCACACAATT
AGGGTACGCTACGCGATAG -> GGGTACGCTACGCGATAGC
AGGGTAGGTATGCGTGTAC -> GGGTAGGTATGCGTGTACA
AGGGTATTCATTTCAGACA -> GGGTATTCATTTCAGACAC
AGGGTGCGTAAACAATTAA -> GGGTGCGTAAACAATTAAT
AGGGTTACGGCAGACTTTA -> GGGTTACGGCAGACTTTAC
AGGGTTTCCTCTCTTTGGT -> GGGTTTCCTCTCTTTGGTG
AGGGTTTGCTGATGGAAGA -> GGGTTTGCTGATGGAAGAG
AGGTACGGGTATATTAGAC -> GGTACGGGTATATTAGACT
AGGTATGCGTGTACAGTTA -> GGTATGCGTGTACAGTTAT
AGGTATGGTAGTATGGAGA -> GGTATGGTAGTATGGAGAT
AGGTCATGGAAAATGTAGC -> GGTCATGGAAAATGTAGCC
AGGTGGCCAATCGGGTCCC -> GGTGGCCAATCGGGTCCCA
AGGTGTATAACCCTGCAAT -> GGTGTATAACCCTGCAATT
AGGTTCTAGACTGTTCTGC -> GGTTCTAGACTGTTCTGCC
AGGTTTGTTTATCTGGCAA -> GGTTTGTTTATCTGGCAAG
AGTACCGCTCGACAAAGAG -> GTACCGCTCGACAAAGAGC
AGTAGACTTATCCTGATCT -> GTAGACTTATCCTGATCTA
AGTAGCAGAGAGTGTTGTA -> GTAGCAGAGAGTGTTGTAT
AGTATCAGTGGCAACCGTC -> GTATCAGTGGCAACCGTCA
AGTATGGAGATGGTATACT -> GTATGGAGATGGTATACTA
AGTCCCGACCCGTGCCGCC -> GTCCCGACCCGTGCCGCCC
AGTCGCGCAAGTGGACCAA -> GTCGCGCAAGTGGACCAAG
AGTCGTGTACAGGACGTGG -> GTCGTGTACAGGACGTGGT
AGTCTGCTATTGAAAGCTG -> GTCTGCTATTGAAAGCTGA
AGTGAGGCCAAGGGAGTAT -> GTGAGGCCAAGGGAGTATC
AGTGAGTTTTCGTGACAGA -> GTGAGTTTTCGTGACAGAT
AGTGCGCTCTGCGGGGGAT -> GTGCGCTCTGCGGGGGATC
AGTGGACCAAGGTTCTAGA -> GTGGACCAAGGTTCTAGAC
AGTGGAGGACCCTACGCGC -> GTGGAGGACCCTACGCGCT
AGTGGCAACCGTCATAGAT -> GTGGCAACCGTCATAGATC
AGTGGGATGTGTTCACGCA -> GTGGGATGTGTTCACGCAA
AGTGTATCTGGCGGATACT -> GTGTATCTGGCGGATACTT
AGTGTGAGCCTCGTACTTA -> GTGTGAGCCTCGTACTTAC
AGTGTGGTGTGTGATGTAC -> GTGTGGTGTGTGATGTACC
AGTGTTGTATGGACACTCT -> GTGTTGTATGGACACTCTC
AGTTATGCGATCCACCTTG -> GTTATGCGATCCACCTTGA
AGTTCCAAATCATCTTGGC -> GTTCCAAATCATCTTGGCT
AGTTTCGACTGATTCGCAG -> GTTTCGACTGATTCGCAGC
AGTTTTCGTGACAGATGCA -> GTTTTCGTGACAGATGCAA
ATAAAAGTAGCAGAGAGTG -> TAAAAGTAGCAGAGAGTGT
ATAACCCTGCAATTCAAAT -> TAACCCTGCAATTCAAATG
ATAACGCAAGTGTGAGCCT -> TAACGCAAGTGTGAGCCTC
ATACAACCGCTGGCAAGGT -> TACAACCGCTGGCAAGGTT
ATACCTCCGTTCCACAGGC -> TACCTCCGTTCCACAGGCA
ATACCTTAATCCTCTATGA -> TACCTTAATCCTCTATGAC
ATACGCACGTCTGATGAAT -> TACGCACGTCTGATGAATA
ATACGGGTTCCATGCGTTT -> TACGGGTTCCATGCGTTTC
ATACTATATTCTATGCAAT -> TACTATATTCTATGCAATA
ATACTTAACAATGGAAGGG -> TACTTAACAATGGAAGGGG
ATAGAAACCGGCCGTGCGG -> TAGAAACCGGCCGTGCGGG
ATAGAGCCAATGCTTGAAG -> TAGAGCCAATGCTTGAAGG
ATAGATCTCGACTCTCAGA -> TAGATCTCGACTCTCAGAT
ATAGCAGAGATTGGCTTCA -> TAGCAGAGATTGGCTTCAA
ATAGCTACTTCAGAGTAGA -> TAGCTACTTCAGAGTAGAC
ATAGCTGTGCACACATCTG -> TAGCTGTGCACACATCTGA
ATAGGACGTGGTCATCGGA -> TAGGACGTGGTCATCGGAC
ATAGGCAATGCCGACCCAG -> TAGGCAATGCCGACCCAGC
ATAGGGTTTGCTGATGGAA -> TAGGGTTTGCTGATGGAAG
ATATCACTACAGAAAATGA -> TATCACTACAGAAAATGAC
ATATCCTGCTAATCCTTAA -> TATCCTGCTAATCCTTAAT
ATATTAGACTCTATCCCTT -> TATTAGACTCTATCCCTTT
ATATTCTATGCAATAGGCA -> TATTCTATGCAATAGGCAA
ATATTGCCCGGTTACACCC -> TATTGCCCGGTTACACCCC
ATCAAGTGGAGGACCCTAC -> TCAAGTGGAGGACCCTACG
ATCAATTTACTCACTATAT -> TCAATTTACTCACTATATC
ATCACTACAGAAAATGACT -> TCACTACAGAAAATGACTA
ATCACTACCGCGGTTCCAT -> TCACTACCGCGGTTCCATG
ATCACTTCATTTCGCTTTG -> TCACTTCATTTCGCTTTGA
ATCAGTGGCAACCGTCATA -> TCAGTGGCAACCGTCATAG
ATCATATTGCCCGGTTACA -> TCATATTGCCCGGTTACAC
ATCATCTTGGCTTGTAAAG -> TCATCTTGGCTTGTAAAGA
ATCCACCTTGACGGTAAGG -> TCCACCTTGACGGTAAGGC
ATCCCGCCGTCAGCGCAAG -> TCCCGCCGTCAGCGCAAGA
ATCCCTTTAATCCTTCCCG -> TCCCTTTAATCCTTCCCGC
ATCCTCTATGACTCAGAAT -> TCCTCTATGACTCAGAATT
ATCCTGATCTAAGGCTTGA -> TCCTGATCTAAGGCTTGAC
ATCCTGCTAATCCTTAATA -> TCCTGCTAATCCTTAATAA
ATCCTTAATAAAAGTAGCA -> TCCTTAATAAAAGTAGCAG
ATCCTTCCCGCATCTCAGC -> TCCTTCCCGCATCTCAGCA
ATCGCCAGGCTCGTGGAAT -> TCGCCAGGCTCGTGGAATG
ATCGCGTACTATAGCTGTG -> TCGCGTACTATAGCTGTGC
ATCGCTTTACTGAAAATGA -> TCGCTTTACTGAAAATGAC
ATCGGACAACCAAACACGC -> TCGGACAACCAAACACGCA
ATCGGACACCAGTACCGCT -> TCGGACACCAGTACCGCTC
ATCGGACAGGCTATCTCAA -> TCGGACAGGCTATCTCAAC
ATCGGACAGTGCGCTCTGC -> TCGGACAGTGCGCTCTGCG
ATCGGGTCCCAGAGATGAG -> TCGGGTCCCAGAGATGAGT
ATCGTCCGAAAATGACTAT -> TCGTCCGAAAATGACTATG
ATCTAAATCTATTTGCTGC -> TCTAAATCTATTTGCTGCG
ATCTAAGGCTTGACGCATT -> TCTAAGGCTTGACGCATTT
ATCTATTTGCTGCGACTGC -> TCTATTTGCTGCGACTGCG
ATCTCAACGTAGGTCATGG -> TCTCAACGTAGGTCATGGA
ATCTCAGCAGAGGATGGGT -> TCTCAGCAGAGGATGGGTC
ATCTCGACTCTCAGATGCC -> TCTCGACTCTCAGATGCCA
ATCTGAGCCAGTTTCGACT -> TCTGAGCCAGTTTCGACTG
ATCTGCTTTGGTTGCCAGG -> TCTGCTTTGGTTGCCAGGG
ATCTGGACGTGGTGATGAG -> TCTGGACGTGGTGATGAGG
ATCTGGCAAGCCCGTCGAT -> TCTGGCAAGCCCGTCGATA
ATCTGGCGGATACTTAACA -> TCTGGCGGATACTTAACAA
ATCTTGAGTGTGGTGTGTG -> TCTTGAGTGTGGTGTGTGA
ATCTTGGCTTGTAAAGAGG -> TCTTGGCTTGTAAAGAGGT
ATGAAGGTATGGTAGTATG -> TGAAGGTATGGTAGTATGG
ATGAATATCACTACAGAAA -> TGAATATCACTACAGAAAA
ATGACGGAAACTTCCCAAG -> TGACGGAAACTTCCCAAGG
ATGACGGCAATTCCCAACG -> TGACGGCAATTCCCAACGA
ATGACGGCCGCGTTGGGAT -> TGACGGCCGCGTTGGGATA
ATGACGGCGAGTCGTGTAC -> TGACGGCGAGTCGTGTACA
ATGACGGCTGGCGAGACGT -> TGACGGCTGGCGAGACGTA
ATGACTATGACGGCAATTC -> TGACTATGACGGCAATTCC
ATGACTATGACGGCCGCGT -> TGACTATGACGGCCGCGTT
ATGACTATGACGGCGAGTC -> TGACTATGACGGCGAGTCG
ATGACTATGACGGCTGGCG -> TGACTATGACGGCTGGCGA
ATGACTCAGAATTTAAGAA -> TGACTCAGAATTTAAGAAA
ATGAGGATTTCCTGGGCTA -> TGAGGATTTCCTGGGCTAA
ATGAGTTCCAAATCATCTT -> TGAGTTCCAAATCATCTTG
ATGATAACGCAAGTGTGAG -> TGATAACGCAAGTGTGAGC
ATGATCTTGAGTGTGGTGT -> TGATCTTGAGTGTGGTGTG
ATGATTTTACCCTCGGCCT -> TGATTTTACCCTCGGCCTG
ATGCAAGGACGTTTGTCAA -> TGCAAGGACGTTTGTCAAC
ATGCAATAGGCAATGCCGA -> TGCAATAGGCAATGCCGAC
ATGCACGTTCGAGGCTCTT -> TGCACGTTCGAGGCTCTTT
ATGCCATCTGGACGTGGTG -> TGCCATCTGGACGTGGTGA
ATGCCCCCGCACGTTGCAG -> TGCCCCCGCACGTTGCAGT
ATGCCCGCGTTCTCAAGTC -> TGCCCGCGTTCTCAAGTCC
ATGCCGACCCAGCTTAATC -> TGCCGACCCAGCTTAATCA
ATGCCGAGCCCTTGTTATA -> TGCCGAGCCCTTGTTATAC
ATGCCGGTTAGTCGCGCAA -> TGCCGGTTAGTCGCGCAAG
ATGCGATCCACCTTGACGG -> TGCGATCCACCTTGACGGT
ATGCGTGTACAGTTATGCG -> TGCGTGTACAGTTATGCGA
ATGCGTTTCTGAGGCGAAT -> TGCGTTTCTGAGGCGAATA
ATGCTTGAAGGCGTTAACC -> TGCTTGAAGGCGTTAACCA
ATGGAAAATGTAGCCTTGT -> TGGAAAATGTAGCCTTGTT
ATGGAAGAGGGTTTCCTCT -> TGGAAGAGGGTTTCCTCTC
ATGGAAGGGGCCGACGCAC -> TGGAAGGGGCCGACGCACA
ATGGACACTCTCTCTTGAA -> TGGACACTCTCTCTTGAAC
ATGGAGATGGTATACTATA -> TGGAGATGGTATACTATAT
ATGGGGGCGCTGGTATGAT -> TGGGGGCGCTGGTATGATC
ATGGGTCCGAACTGCCTTA -> TGGGTCCGAACTGCCTTAT
ATGGTAGTATGGAGATGGT -> TGGTAGTATGGAGATGGTA
ATGGTATACTATATTCTAT -> TGGTATACTATATTCTATG
ATGGTGCAATCGCCAGGCT -> TGGTGCAATCGCCAGGCTC
ATGTAATTGGTGAGACGCT -> TGTAATTGGTGAGACGCTA
ATGTACCTATCGCGTACTA -> TGTACCTATCGCGTACTAT
ATGTAGCCTTGTTAGGAAG -> TGTAGCCTTGTTAGGAAGA
ATGTGTTCACGCAACCGCC -> TGTGTTCACGCAACCGCCC
ATGTTTCTCATAGAGCCAA -> TGTTTCTCATAGAGCCAAT
ATTAATTATCGCTTTACTG -> TTAATTATCGCTTTACTGA
ATTAGAAGTGTATCTGGCG -> TTAGAAGTGTATCTGGCGG
ATTAGACTCTATCCCTTTA -> TTAGACTCTATCCCTTTAA
ATTAGCTTCTCTAAACCCT -> TTAGCTTCTCTAAACCCTG
ATTAGGGCGGGGGTTGGGC -> TTAGGGCGGGGGTTGGGCA
ATTATCGCTTTACTGAAAA -> TTATCGCTTTACTGAAAAT
ATTCAAATGCCCGCGTTCT -> TTCAAATGCCCGCGTTCTC
ATTCATTTCAGACACTATA -> TTCATTTCAGACACTATAC
ATTCCCAACGAGGACGTGG -> TTCCCAACGAGGACGTGGT
ATTCGCAGCTTCCCGGCGG -> TTCGCAGCTTCCCGGCGGA
ATTCTATGCAATAGGCAAT -> TTCTATGCAATAGGCAATG
ATTCTCAGCCAACCTAACC -> TTCTCAGCCAACCTAACCA
ATTGAAAGCTGATGAAGGT -> TTGAAAGCTGATGAAGGTA
ATTGCCACGAAGACTAACT -> TTGCCACGAAGACTAACTT
ATTGCCCGGTTACACCCCT -> TTGCCCGGTTACACCCCTC
ATTGGCTTCAACCCTGCAT -> TTGGCTTCAACCCTGCATG
ATTGGTGAGACGCTATTTC -> TTGGTGAGACGCTATTTCC
ATTTAACGGGACACTTTAA -> TTTAACGGGACACTTTAAA
ATTTAAGAAACCAGAACCG -> TTTAAGAAACCAGAACCGC
ATTTACTCACTATATCCTG -> TTTACTCACTATATCCTGC
ATTTCAGACACTATACGGG -> TTTCAGACACTATACGGGT
ATTTCCAATACCTCCGTTC -> TTTCCAATACCTCCGTTCC
ATTTCCTGGGCTAACCTCT -> TTTCCTGGGCTAACCTCTC
ATTTCGCTTTGACAGTGGG -> TTTCGCTTTGACAGTGGGA
ATTTGCGTGCCAAGTCTGC -> TTTGCGTGCCAAGTCTGCT
ATTTGCTGCGACTGCGCCA -> TTTGCTGCGACTGCGCCAG
ATTTGTCTCGGTTAGATAG -> TTTGTCTCGGTTAGATAGC
ATTTTACCCTCGGCCTGTC -> TTTTACCCTCGGCCTGTCT
CAAAACATCGTCCGAAAAT -> AAAACATCGTCCGAAAATG
CAAAAGGGTAGGTATGCGT -> AAAAGGGTAGGTATGCGTG
CAAACACGCAGCCAGCCCG -> AAACACGCAGCCAGCCCGC
CAAACGTATCTGCTTTGGT -> AAACGTATCTGCTTTGGTT
CAAAGAGCCTGGCACCCGA -> AAAGAGCCTGGCACCCGAC
CAAATCATCTTGGCTTGTA -> AAATCATCTTGGCTTGTAA
CAAATGCCCGCGTTCTCAA -> AAATGCCCGCGTTCTCAAG
CAACCAAACACGCAGCCAG -> AACCAAACACGCAGCCAGC
CAACCCTGCATGACGGAAA -> AACCCTGCATGACGGAAAC
CAACCGCCCGGCACTCCCA -> AACCGCCCGGCACTCCCAT
CAACCGCTGGCAAGGTTTG -> AACCGCTGGCAAGGTTTGT
CAACCGTCATAGATCTCGA -> AACCGTCATAGATCTCGAC
CAACCTAACCATCTAAATC -> AACCTAACCATCTAAATCT
CAACGAGGACGTGGTCATC -> AACGAGGACGTGGTCATCG
CAACGTAGGTCATGGAAAA -> AACGTAGGTCATGGAAAAT
CAACGTCTAACTCTAGATG -> AACGTCTAACTCTAGATGT
CAACTCATACGCACGTCTG -> AACTCATACGCACGTCTGA
CAAGAAACGGGTCACTCGG -> AAGAAACGGGTCACTCGGA
CAAGACCAAGAAACGGGTC -> AAGACCAAGAAACGGGTCA
CAAGAGGGTATTCATTTCA -> AAGAGGGTATTCATTTCAG
CAAGATGCACGTTCGAGGC -> AAGATGCACGTTCGAGGCT
CAAGCCCGTCGATAGGGTT -> AAGCCCGTCGATAGGGTTT
CAAGGACGTTTGTCAACTC -> AAGGACGTTTGTCAACTCA
CAAGGGAGTATCAGTGGCA -> AAGGGAGTATCAGTGGCAA
CAAGGGTACGCTACGCGAT -> AAGGGTACGCTACGCGATA
CAAGGTACGGGTATATTAG -> AAGGTACGGGTATATTAGA
CAAGGTTCTAGACTGTTCT -> AAGGTTCTAGACTGTTCTG
CAAGGTTTGTTTATCTGGC -> AAGGTTTGTTTATCTGGCA
CAAGTCCCGACCCGTGCCG -> AAGTCCCGACCCGTGCCGC
CAAGTCTGCTATTGAAAGC -> AAGTCTGCTATTGAAAGCT
CAAGTGGACCAAGGTTCTA -> AAGTGGACCAAGGTTCTAG
CAAGTGGAGGACCCTACGC -> AAGTGGAGGACCCTACGCG
CAAGTGTGAGCCTCGTACT -> AAGTGTGAGCCTCGTACTT
CAATACCTCCGTTCCACAG -> AATACCTCCGTTCCACAGG
CAATAGAAACCGGCCGTGC -> AATAGAAACCGGCCGTGCG
CAATAGGCAATGCCGACCC -> AATAGGCAATGCCGACCCA
CAATCGCCAGGCTCGTGGA -> AATCGCCAGGCTCGTGGAA
CAATCGGGTCCCAGAGATG -> AATCGGGTCCCAGAGATGA
CAATGCCGACCCAGCTTAA -> AATGCCGACCCAGCTTAAT
CAATGCTTGAAGGCGTTAA -> AATGCTTGAAGGCGTTAAC
CAATGGAAGGGGCCGACGC -> AATGGAAGGGGCCGACGCA
CAATTAATTATCGCTTTAC -> AATTAATTATCGCTTTACT
CAATTAGGGCGGGGGTTGG -> AATTAGGGCGGGGGTTGGG
CAATTCAAATGCCCGCGTT -> AATTCAAATGCCCGCGTTC
CAATTCCCAACGAGGACGT -> AATTCCCAACGAGGACGTG
CAATTTAACGGGACACTTT -> AATTTAACGGGACACTTTA
CAATTTACTCACTATATCC -> AATTTACTCACTATATCCT
CACAAAAGGGTAGGTATGC -> ACAAAAGGGTAGGTATGCG
CACAATTTAACGGGACACT -> ACAATTTAACGGGACACTT
CACACAATTTAACGGGACA -> ACACAATTTAACGGGACAC
CACACAGGATGCCGGTTAG -> ACACAGGATGCCGGTTAGT
CACACATCTGAGCCAGTTT -> ACACATCTGAGCCAGTTTC
CACACGCAAGACCAAGAAA -> ACACGCAAGACCAAGAAAC
CACAGGATGCCGGTTAGTC -> ACAGGATGCCGGTTAGTCG
CACAGGCATTTGTCTCGGT -> ACAGGCATTTGTCTCGGTT
CACATCTGAGCCAGTTTCG -> ACATCTGAGCCAGTTTCGA
CACCAGTACCGCTCGACAA -> ACCAGTACCGCTCGACAAA
CACCCCTCTTTGGATTCTC -> ACCCCTCTTTGGATTCTCA
CACCCGACCAGGGTTACGG -> ACCCGACCAGGGTTACGGC
CACCTTGACGGTAAGGCGA -> ACCTTGACGGTAAGGCGAT
CACGAAGACTAACTTCACA -> ACGAAGACTAACTTCACAC
CACGACTCTGCAAAACATC -> ACGACTCTGCAAAACATCG
CACGCAACCGCCCGGCACT -> ACGCAACCGCCCGGCACTC
CACGCAAGACCAAGAAACG -> ACGCAAGACCAAGAAACGG
CACGCAGCCAGCCCGCCAA -> ACGCAGCCAGCCCGCCAAA
CACGTCTGATCAAGTGGAG -> ACGTCTGATCAAGTGGAGG
CACGTCTGATGAATATCAC -> ACGTCTGATGAATATCACT
CACGTTCGAGGCTCTTTTT -> ACGTTCGAGGCTCTTTTTT
CACGTTGCAGTGAGGCCAA -> ACGTTGCAGTGAGGCCAAG
CACTACAGAAAATGACTAT -> ACTACAGAAAATGACTATG
CACTACCGCGGTTCCATGA -> ACTACCGCGGTTCCATGAT
CACTATACGGGTTCCATGC -> ACTATACGGGTTCCATGCG
CACTATATCCTGCTAATCC -> ACTATATCCTGCTAATCCT
CACTCCCATGCCCCCGCAC -> ACTCCCATGCCCCCGCACG
CACTCGGATCACTACCGCG -> ACTCGGATCACTACCGCGG
CACTCTCTCTTGAACACGT -> ACTCTCTCTTGAACACGTC
CACTTCATTTCGCTTTGAC -> ACTTCATTTCGCTTTGACA
CACTTGTGGTGTCAATTAG -> ACTTGTGGTGTCAATTAGG
CACTTTAAAGATGATTTTA -> ACTTTAAAGATGATTTTAC
CAGAAAATGACTATGACGG -> AGAAAATGACTATGACGGC
CAGAACCGCACGACTCTGC -> AGAACCGCACGACTCTGCA
CAGAATTTAAGAAACCAGA -> AGAATTTAAGAAACCAGAA
CAGACACTATACGGGTTCC -> AGACACTATACGGGTTCCA
CAGACTTTACAACGTCTAA -> AGACTTTACAACGTCTAAC
CAGAGAGTGTTGTATGGAC -> AGAGAGTGTTGTATGGACA
CAGAGATGAGTTCCAAATC -> AGAGATGAGTTCCAAATCA
CAGAGATTGGCTTCAACCC -> AGAGATTGGCTTCAACCCT
CAGAGGATGGGTCCGAACT -> AGAGGATGGGTCCGAACTG
CAGAGTAGACTTATCCTGA -> AGAGTAGACTTATCCTGAT
CAGATGCAAGGACGTTTGT -> AGATGCAAGGACGTTTGTC
CAGATGCCATCTGGACGTG -> AGATGCCATCTGGACGTGG
CAGCAGAGGATGGGTCCGA -> AGCAGAGGATGGGTCCGAA
CAGCCAACCTAACCATCTA -> AGCCAACCTAACCATCTAA
CAGCCAGCCCGCCAAACGT -> AGCCAGCCCGCCAAACGTA
CAGCCCGCCAAACGTATCT -> AGCCCGCCAAACGTATCTG
CAGCGCAAGAGGGTATTCA -> AGCGCAAGAGGGTATTCAT
CAGCTTAATCACTTCATTT -> AGCTTAATCACTTCATTTC
CAGCTTCCCGGCGGAAAAT -> AGCTTCCCGGCGGAAAATG
CAGGAAGCCCCTGGCAATA -> AGGAAGCCCCTGGCAATAG
CAGGACGTGGTCATCGGAC -> AGGACGTGGTCATCGGACA
CAGGATGCCGGTTAGTCGC -> AGGATGCCGGTTAGTCGCG
CAGGCATTTGTCTCGGTTA -> AGGCATTTGTCTCGGTTAG
CAGGCTATCTCAACGTAGG -> AGGCTATCTCAACGTAGGT
CAGGCTCGTGGAATGTAAT -> AGGCTCGTGGAATGTAATT
CAGGGACAAGATGCACGTT -> AGGGACAAGATGCACGTTC
CAGGGTTACGGCAGACTTT -> AGGGTTACGGCAGACTTTA
CAGTACCGCTCGACAAAGA -> AGTACCGCTCGACAAAGAG
CAGTGAGGCCAAGGGAGTA -> AGTGAGGCCAAGGGAGTAT
CAGTGAGTTTTCGTGACAG -> AGTGAGTTTTCGTGACAGA
CAGTGCGCTCTGCGGGGGA -> AGTGCGCTCTGCGGGGGAT
CAGTGGCAACCGTCATAGA -> AGTGGCAACCGTCATAGAT
CAGTGGGATGTGTTCACGC -> AGTGGGATGTGTTCACGCA
CAGTTATGCGATCCACCTT -> AGTTATGCGATCCACCTTG
CAGTTTCGACTGATTCGCA -> AGTTTCGACTGATTCGCAG
CATACGCACGTCTGATGAA -> ATACGCACGTCTGATGAAT
CATAGAGCCAATGCTTGAA -> ATAGAGCCAATGCTTGAAG
CATAGATCTCGACTCTCAG -> ATAGATCTCGACTCTCAGA
CATATTGCCCGGTTACACC -> ATATTGCCCGGTTACACCC
CATCGGACAACCAAACACG -> ATCGGACAACCAAACACGC
CATCGGACACCAGTACCGC -> ATCGGACACCAGTACCGCT
CATCGGACAGGCTATCTCA -> ATCGGACAGGCTATCTCAA
CATCGGACAGTGCGCTCTG -> ATCGGACAGTGCGCTCTGC
CATCGTCCGAAAATGACTA -> ATCGTCCGAAAATGACTAT
CATCTAAATCTATTTGCTG -> ATCTAAATCTATTTGCTGC
CATCTCAGCAGAGGATGGG -> ATCTCAGCAGAGGATGGGT
CATCTGAGCCAGTTTCGAC -> ATCTGAGCCAGTTTCGACT
CATCTGGACGTGGTGATGA -> ATCTGGACGTGGTGATGAG
CATCTTGGCTTGTAAAGAG -> ATCTTGGCTTGTAAAGAGG
CATGACGGAAACTTCCCAA -> ATGACGGAAACTTCCCAAG
CATGATAACGCAAGTGTGA -> ATGATAACGCAAGTGTGAG
CATGCCCCCGCACGTTGCA -> ATGCCCCCGCACGTTGCAG
CATGCGTTTCTGAGGCGAA -> ATGCGTTTCTGAGGCGAAT
CATGGAAAATGTAGCCTTG -> ATGGAAAATGTAGCCTTGT
CATGGGGGCGCTGGTATGA -> ATGGGGGCGCTGGTATGAT
CATGGTGCAATCGCCAGGC -> ATGGTGCAATCGCCAGGCT
CATTTCAGACACTATACGG -> ATTTCAGACACTATACGGG
CATTTCGCTTTGACAGTGG -> ATTTCGCTTTGACAGTGGG
CATTTGCGTGCCAAGTCTG -> ATTTGCGTGCCAAGTCTGC
CATTTGTCTCGGTTAGATA -> ATTTGTCTCGGTTAGATAG
CCAAACACGCAGCCAGCCC -> CAAACACGCAGCCAGCCCG
CCAAACGTATCTGCTTTGG -> CAAACGTATCTGCTTTGGT
CCAAATCATCTTGGCTTGT -> CAAATCATCTTGGCTTGTA
CCAACCTAACCATCTAAAT -> CAACCTAACCATCTAAATC
CCAACGAGGACGTGGTCAT -> CAACGAGGACGTGGTCATC
CCAAGAAACGGGTCACTCG -> CAAGAAACGGGTCACTCGG
CCAAGGGAGTATCAGTGGC -> CAAGGGAGTATCAGTGGCA
CCAAGGTACGGGTATATTA -> CAAGGTACGGGTATATTAG
CCAAGGTTCTAGACTGTTC -> CAAGGTTCTAGACTGTTCT
CCAAGTCTGCTATTGAAAG -> CAAGTCTGCTATTGAAAGC
CCAATACCTCCGTTCCACA -> CAATACCTCCGTTCCACAG
CCAATCGGGTCCCAGAGAT -> CAATCGGGTCCCAGAGATG
CCAATGCTTGAAGGCGTTA -> CAATGCTTGAAGGCGTTAA
CCACAGGCATTTGTCTCGG -> CACAGGCATTTGTCTCGGT
CCACCTTGACGGTAAGGCG -> CACCTTGACGGTAAGGCGA
CCACGAAGACTAACTTCAC -> CACGAAGACTAACTTCACA
CCACTTGTGGTGTCAATTA -> CACTTGTGGTGTCAATTAG
CCAGAACCGCACGACTCTG -> CAGAACCGCACGACTCTGC
CCAGAGATGAGTTCCAAAT -> CAGAGATGAGTTCCAAATC
CCAGCCCGCCAAACGTATC -> CAGCCCGCCAAACGTATCT
CCAGCTTAATCACTTCATT -> CAGCTTAATCACTTCATTT
CCAGGCTCGTGGAATGTAA -> CAGGCTCGTGGAATGTAAT
CCAGGGACAAGATGCACGT -> CAGGGACAAGATGCACGTT
CCAGGGTTACGGCAGACTT -> CAGGGTTACGGCAGACTTT
CCAGTACCGCTCGACAAAG -> CAGTACCGCTCGACAAAGA
CCAGTTTCGACTGATTCGC -> CAGTTTCGACTGATTCGCA
CCATCTAAATCTATTTGCT -> CATCTAAATCTATTTGCTG
CCATCTGGACGTGGTGATG -> CATCTGGACGTGGTGATGA
CCATGATAACGCAAGTGTG -> CATGATAACGCAAGTGTGA
CCATGCCCCCGCACGTTGC -> CATGCCCCCGCACGTTGCA
CCATGCGTTTCTGAGGCGA -> CATGCGTTTCTGAGGCGAA
CCATGGTGCAATCGCCAGG -> CATGGTGCAATCGCCAGGC
CCCAACGAGGACGTGGTCA -> CCAACGAGGACGTGGTCAT
CCCAAGGTACGGGTATATT -> CCAAGGTACGGGTATATTA
CCCAGAGATGAGTTCCAAA -> CCAGAGATGAGTTCCAAAT
CCCAGCTTAATCACTTCAT -> CCAGCTTAATCACTTCATT
CCCATGCCCCCGCACGTTG -> CCATGCCCCCGCACGTTGC
CCCCCGCACGTTGCAGTGA -> CCCCGCACGTTGCAGTGAG
CCCCGCACGTTGCAGTGAG -> CCCGCACGTTGCAGTGAGG
CCCCTCTTTGGATTCTCAG -> CCCTCTTTGGATTCTCAGC
CCCCTGGCAATAGAAACCG -> CCCTGGCAATAGAAACCGG
CCCGACCAGGGTTACGGCA -> CCGACCAGGGTTACGGCAG
CCCGACCCGTGCCGCCCTC -> CCGACCCGTGCCGCCCTCG
CCCGCACGTTGCAGTGAGG -> CCGCACGTTGCAGTGAGGC
CCCGCATCTCAGCAGAGGA -> CCGCATCTCAGCAGAGGAT
CCCGCCAAACGTATCTGCT -> CCGCCAAACGTATCTGCTT
CCCGCCGTCAGCGCAAGAG -> CCGCCGTCAGCGCAAGAGG
CCCGCGTTCTCAAGTCCCG -> CCGCGTTCTCAAGTCCCGA
CCCGGCACTCCCATGCCCC -> CCGGCACTCCCATGCCCCC
CCCGGCGGAAAATGACTAT -> CCGGCGGAAAATGACTATG
CCCGGTTACACCCCTCTTT -> CCGGTTACACCCCTCTTTG
CCCGTCGATAGGGTTTGCT -> CCGTCGATAGGGTTTGCTG
CCCGTGCCGCCCTCGAGGG -> CCGTGCCGCCCTCGAGGGT
CCCTACGCGCTGTGGTCGG -> CCTACGCGCTGTGGTCGGA
CCCTCGAGGGTGCGTAAAC -> CCTCGAGGGTGCGTAAACA
CCCTCGGCCTGTCTAGAGG -> CCTCGGCCTGTCTAGAGGA
CCCTCTTTGGATTCTCAGC -> CCTCTTTGGATTCTCAGCC
CCCTGCAATTCAAATGCCC -> CCTGCAATTCAAATGCCCG
CCCTGCATGACGGAAACTT -> CCTGCATGACGGAAACTTC
CCCTGGAGGTGGCCAATCG -> CCTGGAGGTGGCCAATCGG
CCCTGGCAATAGAAACCGG -> CCTGGCAATAGAAACCGGC
CCCTTGTTATACCTTAATC -> CCTTGTTATACCTTAATCC
CCCTTTAATCCTTCCCGCA -> CCTTTAATCCTTCCCGCAT
CCGAAAATGACTATGACGG -> CGAAAATGACTATGACGGC
CCGAACTGCCTTATTGCCA -> CGAACTGCCTTATTGCCAC
CCGACACAAAAGGGTAGGT -> CGACACAAAAGGGTAGGTA
CCGACCAGGGTTACGGCAG -> CGACCAGGGTTACGGCAGA
CCGACCCAGCTTAATCACT -> CGACCCAGCTTAATCACTT
CCGACCCGTGCCGCCCTCG -> CGACCCGTGCCGCCCTCGA
CCGACGCACACAATTTAAC -> CGACGCACACAATTTAACG
CCGAGCCCTTGTTATACCT -> CGAGCCCTTGTTATACCTT
CCGCACGACTCTGCAAAAC -> CGCACGACTCTGCAAAACA
CCGCACGTTGCAGTGAGGC -> CGCACGTTGCAGTGAGGCC
CCGCATCTCAGCAGAGGAT -> CGCATCTCAGCAGAGGATG
CCGCCAAACGTATCTGCTT -> CGCCAAACGTATCTGCTTT
CCGCCCGGCACTCCCATGC -> CGCCCGGCACTCCCATGCC
CCGCCCTCGAGGGTGCGTA -> CGCCCTCGAGGGTGCGTAA
CCGCCGACACAAAAGGGTA -> CGCCGACACAAAAGGGTAG
CCGCCGTCAGCGCAAGAGG -> CGCCGTCAGCGCAAGAGGG
CCGCGGTTCCATGATAACG -> CGCGGTTCCATGATAACGC
CCGCGTATTAGAAGTGTAT -> CGCGTATTAGAAGTGTATC
CCGCGTTCTCAAGTCCCGA -> CGCGTTCTCAAGTCCCGAC
CCGCGTTGGGATAGGACGT -> CGCGTTGGGATAGGACGTG
CCGCTCGACAAAGAGCCTG -> CGCTCGACAAAGAGCCTGG
CCGCTGGCAAGGTTTGTTT -> CGCTGGCAAGGTTTGTTTA
CCGGAGGAACACACAGGAT -> CGGAGGAACACACAGGATG
CCGGCACTCCCATGCCCCC -> CGGCACTCCCATGCCCCCG
CCGGCCGTGCGGGGTAGAG -> CGGCCGTGCGGGGTAGAGC
CCGGCGGAAAATGACTATG -> CGGCGGAAAATGACTATGA
CCGGTTACACCCCTCTTTG -> CGGTTACACCCCTCTTTGG
CCGGTTAGTCGCGCAAGTG -> CGGTTAGTCGCGCAAGTGG
CCGTCAGCGCAAGAGGGTA -> CGTCAGCGCAAGAGGGTAT
CCGTCATAGATCTCGACTC -> CGTCATAGATCTCGACTCT
CCGTCGATAGGGTTTGCTG -> CGTCGATAGGGTTTGCTGA
CCGTGCCGCCCTCGAGGGT -> CGTGCCGCCCTCGAGGGTG
CCGTGCGGGGTAGAGCGCG -> CGTGCGGGGTAGAGCGCGT
CCGTTAACTGACCGGAGGA -> CGTTAACTGACCGGAGGAA
CCGTTCCACAGGCATTTGT -> CGTTCCACAGGCATTTGTC
CCTAACCATCTAAATCTAT -> CTAACCATCTAAATCTATT
CCTACGCGCTGTGGTCGGA -> CTACGCGCTGTGGTCGGAG
CCTATCGCGTACTATAGCT -> CTATCGCGTACTATAGCTG
CCTCCGTTCCACAGGCATT -> CTCCGTTCCACAGGCATTT
CCTCGAGGGTGCGTAAACA -> CTCGAGGGTGCGTAAACAA
CCTCGGCCTGTCTAGAGGA -> CTCGGCCTGTCTAGAGGAA
CCTCGTACTTACTCCGCGT -> CTCGTACTTACTCCGCGTA
CCTCTATGACTCAGAATTT -> CTCTATGACTCAGAATTTA
CCTCTCTACGAAATTAGCT -> CTCTCTACGAAATTAGCTT
CCTCTCTTTGGTGGTGCCG -> CTCTCTTTGGTGGTGCCGT
CCTCTTTGGATTCTCAGCC -> CTCTTTGGATTCTCAGCCA
CCTGATCTAAGGCTTGACG -> CTGATCTAAGGCTTGACGC
CCTGCAATTCAAATGCCCG -> CTGCAATTCAAATGCCCGC
CCTGCATGACGGAAACTTC -> CTGCATGACGGAAACTTCC
CCTGCTAATCCTTAATAAA -> CTGCTAATCCTTAATAAAA
CCTGGAGGTGGCCAATCGG -> CTGGAGGTGGCCAATCGGG
CCTGGCAATAGAAACCGGC -> CTGGCAATAGAAACCGGCC
CCTGGCACCCGACCAGGGT -> CTGGCACCCGACCAGGGTT
CCTGGGCTAACCTCTCTAC -> CTGGGCTAACCTCTCTACG
CCTGTCTAGAGGAAATGCC -> CTGTCTAGAGGAAATGCCG
CCTTAATAAAAGTAGCAGA -> CTTAATAAAAGTAGCAGAG
CCTTAATCCTCTATGACTC -> CTTAATCCTCTATGACTCA
CCTTACAGTGAGTTTTCGT -> CTTACAGTGAGTTTTCGTG
CCTTATTGCCACGAAGACT -> CTTATTGCCACGAAGACTA
CCTTCCCGCATCTCAGCAG -> CTTCCCGCATCTCAGCAGA
CCTTGACGGTAAGGCGATC -> CTTGACGGTAAGGCGATCC
CCTTGTTAGGAAGAATCAT -> CTTGTTAGGAAGAATCATA
CCTTGTTATACCTTAATCC -> CTTGTTATACCTTAATCCT
CCTTTAATCCTTCCCGCAT -> CTTTAATCCTTCCCGCATC
CGAAAATGACTATGACGGC -> GAAAATGACTATGACGGCC
CGAAATTAGCTTCTCTAAA -> GAAATTAGCTTCTCTAAAC
CGAACTGCCTTATTGCCAC -> GAACTGCCTTATTGCCACG
CGAAGACTAACTTCACACG -> GAAGACTAACTTCACACGC
CGAATACAACCGCTGGCAA -> GAATACAACCGCTGGCAAG
CGACAAAGAGCCTGGCACC -> GACAAAGAGCCTGGCACCC
CGACACAAAAGGGTAGGTA -> GACACAAAAGGGTAGGTAT
CGACCAGGGTTACGGCAGA -> GACCAGGGTTACGGCAGAC
CGACCCAGCTTAATCACTT -> GACCCAGCTTAATCACTTC
CGACCCGTGCCGCCCTCGA -> GACCCGTGCCGCCCTCGAG
CGACGCACACAATTTAACG -> GACGCACACAATTTAACGG
CGACTCTCAGATGCCATCT -> GACTCTCAGATGCCATCTG
CGACTCTGCAAAACATCGT -> GACTCTGCAAAACATCGTC
CGACTGATTCGCAGCTTCC -> GACTGATTCGCAGCTTCCC
CGAGACGTAGGACGTGGTC -> GAGACGTAGGACGTGGTCA
CGAGCCCTTGTTATACCTT -> GAGCCCTTGTTATACCTTA
CGAGGACGTGGTCATCGGA -> GAGGACGTGGTCATCGGAC
CGAGGCTCTTTTTTAGCGC -> GAGGCTCTTTTTTAGCGCA
CGAGGGTGCGTAAACAATT -> GAGGGTGCGTAAACAATTA
CGAGTCGTGTACAGGACGT -> GAGTCGTGTACAGGACGTG
CGATAGCTACTTCAGAGTA -> GATAGCTACTTCAGAGTAG
CGATAGGGTTTGCTGATGG -> GATAGGGTTTGCTGATGGA
CGATCCACCTTGACGGTAA -> GATCCACCTTGACGGTAAG
CGATCCCGCCGTCAGCGCA -> GATCCCGCCGTCAGCGCAA
CGCAACCGCCCGGCACTCC -> GCAACCGCCCGGCACTCCC
CGCAAGACCAAGAAACGGG -> GCAAGACCAAGAAACGGGT
CGCAAGAGGGTATTCATTT -> GCAAGAGGGTATTCATTTC
CGCAAGGGTACGCTACGCG -> GCAAGGGTACGCTACGCGA
CGCAAGTGGACCAAGGTTC -> GCAAGTGGACCAAGGTTCT
CGCAAGTGTGAGCCTCGTA -> GCAAGTGTGAGCCTCGTAC
CGCACACAATTTAACGGGA -> GCACACAATTTAACGGGAC
CGCACGACTCTGCAAAACA -> GCACGACTCTGCAAAACAT
CGCACGTCTGATGAATATC -> GCACGTCTGATGAATATCA
CGCACGTTGCAGTGAGGCC -> GCACGTTGCAGTGAGGCCA
CGCAGCCAGCCCGCCAAAC -> GCAGCCAGCCCGCCAAACG
CGCAGCTTCCCGGCGGAAA -> GCAGCTTCCCGGCGGAAAA
CGCATCTCAGCAGAGGATG -> GCATCTCAGCAGAGGATGG
CGCATTTGCGTGCCAAGTC -> GCATTTGCGTGCCAAGTCT
CGCCAAACGTATCTGCTTT -> GCCAAACGTATCTGCTTTG
CGCCAGGCTCGTGGAATGT -> GCCAGGCTCGTGGAATGTA
CGCCCGGCACTCCCATGCC -> GCCCGGCACTCCCATGCCC
CGCCCTCGAGGGTGCGTAA -> GCCCTCGAGGGTGCGTAAA
CGCCGACACAAAAGGGTAG -> GCCGACACAAAAGGGTAGG
CGCCGTCAGCGCAAGAGGG -> GCCGTCAGCGCAAGAGGGT
CGCGATAGCTACTTCAGAG -> GCGATAGCTACTTCAGAGT
CGCGCAAGTGGACCAAGGT -> GCGCAAGTGGACCAAGGTT
CGCGCTGTGGTCGGAGGCC -> GCGCTGTGGTCGGAGGCCG
CGCGGTTCCATGATAACGC -> GCGGTTCCATGATAACGCA
CGCGTACTATAGCTGTGCA -> GCGTACTATAGCTGTGCAC
CGCGTATTAGAAGTGTATC -> GCGTATTAGAAGTGTATCT
CGCGTCGTAAAACCTTACA -> GCGTCGTAAAACCTTACAG
CGCGTTCTCAAGTCCCGAC -> GCGTTCTCAAGTCCCGACC
CGCGTTGGGATAGGACGTG -> GCGTTGGGATAGGACGTGG
CGCTACGCGATAGCTACTT -> GCTACGCGATAGCTACTTC
CGCTATTTCCAATACCTCC -> GCTATTTCCAATACCTCCG
CGCTCGACAAAGAGCCTGG -> GCTCGACAAAGAGCCTGGC
CGCTCTGCGGGGGATCAAT -> GCTCTGCGGGGGATCAATT
CGCTGGCAAGGTTTGTTTA -> GCTGGCAAGGTTTGTTTAT
CGCTGGTATGATCTTGAGT -> GCTGGTATGATCTTGAGTG
CGCTGTGGTCGGAGGCCGC -> GCTGTGGTCGGAGGCCGCC
CGCTTTACTGAAAATGACT -> GCTTTACTGAAAATGACTA
CGCTTTGACAGTGGGATGT -> GCTTTGACAGTGGGATGTG
CGGAAAATGACTATGACGG -> GGAAAATGACTATGACGGC
CGGAAACTTCCCAAGGTAC -> GGAAACTTCCCAAGGTACG
CGGACAACCAAACACGCAG -> GGACAACCAAACACGCAGC
CGGACACCAGTACCGCTCG -> GGACACCAGTACCGCTCGA
CGGACAGGCTATCTCAACG -> GGACAGGCTATCTCAACGT
CGGACAGTGCGCTCTGCGG -> GGACAGTGCGCTCTGCGGG
CGGAGGAACACACAGGATG -> GGAGGAACACACAGGATGC
CGGAGGCCGCCGACACAAA -> GGAGGCCGCCGACACAAAA
CGGATACTTAACAATGGAA -> GGATACTTAACAATGGAAG
CGGATCACTACCGCGGTTC -> GGATCACTACCGCGGTTCC
CGGCAATTCCCAACGAGGA -> GGCAATTCCCAACGAGGAC
CGGCACTCCCATGCCCCCG -> GGCACTCCCATGCCCCCGC
CGGCAGACTTTACAACGTC -> GGCAGACTTTACAACGTCT
CGGCCGCGTTGGGATAGGA -> GGCCGCGTTGGGATAGGAC
CGGCCGTGCGGGGTAGAGC -> GGCCGTGCGGGGTAGAGCG
CGGCCTGTCTAGAGGAAAT -> GGCCTGTCTAGAGGAAATG
CGGCGAGTCGTGTACAGGA -> GGCGAGTCGTGTACAGGAC
CGGCGGAAAATGACTATGA -> GGCGGAAAATGACTATGAC
CGGCTGGCGAGACGTAGGA -> GGCTGGCGAGACGTAGGAC
CGGGACACTTTAAAGATGA -> GGGACACTTTAAAGATGAT
CGGGGGATCAATTTACTCA -> GGGGGATCAATTTACTCAC
CGGGGGTTGGGCATGGGGG -> GGGGGTTGGGCATGGGGGC
CGGGGTAGAGCGCGTCGTA -> GGGGTAGAGCGCGTCGTAA
CGGGTATATTAGACTCTAT -> GGGTATATTAGACTCTATC
CGGGTCACTCGGATCACTA -> GGGTCACTCGGATCACTAC
CGGGTCCCAGAGATGAGTT -> GGGTCCCAGAGATGAGTTC
CGGGTTCCATGCGTTTCTG -> GGGTTCCATGCGTTTCTGA
CGGTAAGGCGATCCCGCCG -> GGTAAGGCGATCCCGCCGT
CGGTTACACCCCTCTTTGG -> GGTTACACCCCTCTTTGGA
CGGTTAGATAGCAGAGATT -> GGTTAGATAGCAGAGATTG
CGGTTAGTCGCGCAAGTGG -> GGTTAGTCGCGCAAGTGGA
CGGTTCCATGATAACGCAA -> GGTTCCATGATAACGCAAG
CGTAAAACCTTACAGTGAG -> GTAAAACCTTACAGTGAGT
CGTAAACAATTAATTATCG -> GTAAACAATTAATTATCGC
CGTACTATAGCTGTGCACA -> GTACTATAGCTGTGCACAC
CGTACTTACTCCGCGTATT -> GTACTTACTCCGCGTATTA
CGTAGGACGTGGTCATCGG -> GTAGGACGTGGTCATCGGA
CGTAGGTCATGGAAAATGT -> GTAGGTCATGGAAAATGTA
CGTATCTGCTTTGGTTGCC -> GTATCTGCTTTGGTTGCCA
CGTATTAGAAGTGTATCTG -> GTATTAGAAGTGTATCTGG
CGTCAGCGCAAGAGGGTAT -> GTCAGCGCAAGAGGGTATT
CGTCATAGATCTCGACTCT -> GTCATAGATCTCGACTCTC
CGTCCGAAAATGACTATGA -> GTCCGAAAATGACTATGAC
CGTCGATAGGGTTTGCTGA -> GTCGATAGGGTTTGCTGAT
CGTCGTAAAACCTTACAGT -> GTCGTAAAACCTTACAGTG
CGTCTAACTCTAGATGTTT -> GTCTAACTCTAGATGTTTC
CGTCTGATCAAGTGGAGGA -> GTCTGATCAAGTGGAGGAC
CGTCTGATGAATATCACTA -> GTCTGATGAATATCACTAC
CGTGACAGATGCAAGGACG -> GTGACAGATGCAAGGACGT
CGTGCCAAGTCTGCTATTG -> GTGCCAAGTCTGCTATTGA
CGTGCCGCCCTCGAGGGTG -> GTGCCGCCCTCGAGGGTGC
CGTGCGGGGTAGAGCGCGT -> GTGCGGGGTAGAGCGCGTC
CGTGGAATGTAATTGGTGA -> GTGGAATGTAATTGGTGAG
CGTGGTCATCGGACAACCA -> GTGGTCATCGGACAACCAA
CGTGGTCATCGGACACCAG -> GTGGTCATCGGACACCAGT
CGTGGTCATCGGACAGGCT -> GTGGTCATCGGACAGGCTA
CGTGGTCATCGGACAGTGC -> GTGGTCATCGGACAGTGCG
CGTGGTGATGAGGATTTCC -> GTGGTGATGAGGATTTCCT
CGTGTACAGGACGTGGTCA -> GTGTACAGGACGTGGTCAT
CGTGTACAGTTATGCGATC -> GTGTACAGTTATGCGATCC
CGTTAACCATGGTGCAATC -> GTTAACCATGGTGCAATCG
CGTTAACTGACCGGAGGAA -> GTTAACTGACCGGAGGAAC
CGTTCCACAGGCATTTGTC -> GTTCCACAGGCATTTGTCT
CGTTCGAGGCTCTTTTTTA -> GTTCGAGGCTCTTTTTTAG
CGTTCTCAAGTCCCGACCC -> GTTCTCAAGTCCCGACCCG
CGTTGCAGTGAGGCCAAGG -> GTTGCAGTGAGGCCAAGGG
CGTTGGGATAGGACGTGGT -> GTTGGGATAGGACGTGGTC
CGTTTCTGAGGCGAATACA -> GTTTCTGAGGCGAATACAA
CGTTTGTCAACTCATACGC -> GTTTGTCAACTCATACGCA
CTAAACCCTGGAGGTGGCC -> TAAACCCTGGAGGTGGCCA
CTAAATCTATTTGCTGCGA -> TAAATCTATTTGCTGCGAC
CTAACCATCTAAATCTATT -> TAACCATCTAAATCTATTT
CTAACCTCTCTACGAAATT -> TAACCTCTCTACGAAATTA
CTAACTCTAGATGTTTCTC -> TAACTCTAGATGTTTCTCA
CTAACTTCACACGCAAGAC -> TAACTTCACACGCAAGACC
CTAAGGCTTGACGCATTTG -> TAAGGCTTGACGCATTTGC
CTAATCCTTAATAAAAGTA -> TAATCCTTAATAAAAGTAG
CTACAGAAAATGACTATGA -> TACAGAAAATGACTATGAC
CTACCGCGGTTCCATGATA -> TACCGCGGTTCCATGATAA
CTACGAAATTAGCTTCTCT -> TACGAAATTAGCTTCTCTA
CTACGCGATAGCTACTTCA -> TACGCGATAGCTACTTCAG
CTACGCGCTGTGGTCGGAG -> TACGCGCTGTGGTCGGAGG
CTACTTCAGAGTAGACTTA -> TACTTCAGAGTAGACTTAT
CTAGACTGTTCTGCCACTT -> TAGACTGTTCTGCCACTTG
CTAGAGGAAATGCCGAGCC -> TAGAGGAAATGCCGAGCCC
CTAGATGTTTCTCATAGAG -> TAGATGTTTCTCATAGAGC
CTATACGGGTTCCATGCGT -> TATACGGGTTCCATGCGTT
CTATAGCTGTGCACACATC -> TATAGCTGTGCACACATCT
CTATATCCTGCTAATCCTT -> TATATCCTGCTAATCCTTA
CTATATTCTATGCAATAGG -> TATATTCTATGCAATAGGC
CTATCCCTTTAATCCTTCC -> TATCCCTTTAATCCTTCCC
CTATCGCGTACTATAGCTG -> TATCGCGTACTATAGCTGT
CTATCTCAACGTAGGTCAT -> TATCTCAACGTAGGTCATG
CTATGACGGCAATTCCCAA -> TATGACGGCAATTCCCAAC
CTATGACGGCCGCGTTGGG -> TATGACGGCCGCGTTGGGA
CTATGACGGCGAGTCGTGT -> TATGACGGCGAGTCGTGTA
CTATGACGGCTGGCGAGAC -> TATGACGGCTGGCGAGACG
CTATGACTCAGAATTTAAG -> TATGACTCAGAATTTAAGA
CTATGCAATAGGCAATGCC -> TATGCAATAGGCAATGCCG
CTATTGAAAGCTGATGAAG -> TATTGAAAGCTGATGAAGG
CTATTTCCAATACCTCCGT -> TATTTCCAATACCTCCGTT
CTATTTGCTGCGACTGCGC -> TATTTGCTGCGACTGCGCC
CTCAACGTAGGTCATGGAA -> TCAACGTAGGTCATGGAAA
CTCAAGTCCCGACCCGTGC -> TCAAGTCCCGACCCGTGCC
CTCACTATATCCTGCTAAT -> TCACTATATCCTGCTAATC
CTCAGAATTTAAGAAACCA -> TCAGAATTTAAGAAACCAG
CTCAGATGCCATCTGGACG -> TCAGATGCCATCTGGACGT
CTCAGCAGAGGATGGGTCC -> TCAGCAGAGGATGGGTCCG
CTCAGCCAACCTAACCATC -> TCAGCCAACCTAACCATCT
CTCATACGCACGTCTGATG -> TCATACGCACGTCTGATGA
CTCATAGAGCCAATGCTTG -> TCATAGAGCCAATGCTTGA
CTCCCATGCCCCCGCACGT -> TCCCATGCCCCCGCACGTT
CTCCGCGTATTAGAAGTGT -> TCCGCGTATTAGAAGTGTA
CTCCGTTCCACAGGCATTT -> TCCGTTCCACAGGCATTTG
CTCGACAAAGAGCCTGGCA -> TCGACAAAGAGCCTGGCAC
CTCGACTCTCAGATGCCAT -> TCGACTCTCAGATGCCATC
CTCGAGGGTGCGTAAACAA -> TCGAGGGTGCGTAAACAAT
CTCGGATCACTACCGCGGT -> TCGGATCACTACCGCGGTT
CTCGGCCTGTCTAGAGGAA -> TCGGCCTGTCTAGAGGAAA
CTCGGTTAGATAGCAGAGA -> TCGGTTAGATAGCAGAGAT
CTCGTACTTACTCCGCGTA -> TCGTACTTACTCCGCGTAT
CTCGTGGAATGTAATTGGT -> TCGTGGAATGTAATTGGTG
CTCTAAACCCTGGAGGTGG -> TCTAAACCCTGGAGGTGGC
CTCTACGAAATTAGCTTCT -> TCTACGAAATTAGCTTCTC
CTCTAGATGTTTCTCATAG -> TCTAGATGTTTCTCATAGA
CTCTATCCCTTTAATCCTT -> TCTATCCCTTTAATCCTTC
CTCTATGACTCAGAATTTA -> TCTATGACTCAGAATTTAA
CTCTCAGATGCCATCTGGA -> TCTCAGATGCCATCTGGAC
CTCTCTACGAAATTAGCTT -> TCTCTACGAAATTAGCTTC
CTCTCTCTTGAACACGTCT -> TCTCTCTTGAACACGTCTG
CTCTCTTGAACACGTCTGA -> TCTCTTGAACACGTCTGAT
CTCTCTTTGGTGGTGCCGT -> TCTCTTTGGTGGTGCCGTT
CTCTGCAAAACATCGTCCG -> TCTGCAAAACATCGTCCGA
CTCTGCGGGGGATCAATTT -> TCTGCGGGGGATCAATTTA
CTCTTGAACACGTCTGATC -> TCTTGAACACGTCTGATCA
CTCTTTGGATTCTCAGCCA -> TCTTTGGATTCTCAGCCAA
CTCTTTGGTGGTGCCGTTA -> TCTTTGGTGGTGCCGTTAA
CTCTTTTTTAGCGCAAGGG -> TCTTTTTTAGCGCAAGGGT
CTGAAAATGACTATGACGG -> TGAAAATGACTATGACGGC
CTGACCGGAGGAACACACA -> TGACCGGAGGAACACACAG
CTGAGCCAGTTTCGACTGA -> TGAGCCAGTTTCGACTGAT
CTGAGGCGAATACAACCGC -> TGAGGCGAATACAACCGCT
CTGATCAAGTGGAGGACCC -> TGATCAAGTGGAGGACCCT
CTGATCTAAGGCTTGACGC -> TGATCTAAGGCTTGACGCA
CTGATGAAGGTATGGTAGT -> TGATGAAGGTATGGTAGTA
CTGATGAATATCACTACAG -> TGATGAATATCACTACAGA
CTGATGGAAGAGGGTTTCC -> TGATGGAAGAGGGTTTCCT
CTGATTCGCAGCTTCCCGG -> TGATTCGCAGCTTCCCGGC
CTGCAAAACATCGTCCGAA -> TGCAAAACATCGTCCGAAA
CTGCAATTCAAATGCCCGC -> TGCAATTCAAATGCCCGCG
CTGCATGACGGAAACTTCC -> TGCATGACGGAAACTTCCC
CTGCCACTTGTGGTGTCAA -> TGCCACTTGTGGTGTCAAT
CTGCCTTATTGCCACGAAG -> TGCCTTATTGCCACGAAGA
CTGCGACTGCGCCAGCGTG -> TGCGACTGCGCCAGCGTGT
CTGCGGGGGATCAATTTAC -> TGCGGGGGATCAATTTACT
CTGCTAATCCTTAATAAAA -> TGCTAATCCTTAATAAAAG
CTGCTATTGAAAGCTGATG -> TGCTATTGAAAGCTGATGA
CTGCTTTGGTTGCCAGGGA -> TGCTTTGGTTGCCAGGGAC
CTGGACGTGGTGATGAGGA -> TGGACGTGGTGATGAGGAT
CTGGAGGTGGCCAATCGGG -> TGGAGGTGGCCAATCGGGT
CTGGCAAGCCCGTCGATAG -> TGGCAAGCCCGTCGATAGG
CTGGCAAGGTTTGTTTATC -> TGGCAAGGTTTGTTTATCT
CTGGCAATAGAAACCGGCC -> TGGCAATAGAAACCGGCCG
CTGGCACCCGACCAGGGTT -> TGGCACCCGACCAGGGTTA
CTGGCGAGACGTAGGACGT -> TGGCGAGACGTAGGACGTG
CTGGCGGATACTTAACAAT -> TGGCGGATACTTAACAATG
CTGGGCTAACCTCTCTACG -> TGGGCTAACCTCTCTACGA
CTGGTATGATCTTGAGTGT -> TGGTATGATCTTGAGTGTG
CTGTCTAGAGGAAATGCCG -> TGTCTAGAGGAAATGCCGA
CTGTGCACACATCTGAGCC -> TGTGCACACATCTGAGCCA
CTGTGGTCGGAGGCCGCCG -> TGTGGTCGGAGGCCGCCGA
CTGTTCTGCCACTTGTGGT -> TGTTCTGCCACTTGTGGTG
CTTAACAATGGAAGGGGCC -> TTAACAATGGAAGGGGCCG
CTTAATAAAAGTAGCAGAG -> TTAATAAAAGTAGCAGAGA
CTTAATCACTTCATTTCGC -> TTAATCACTTCATTTCGCT
CTTAATCCTCTATGACTCA -> TTAATCCTCTATGACTCAG
CTTACAGTGAGTTTTCGTG -> TTACAGTGAGTTTTCGTGA
CTTACTCCGCGTATTAGAA -> TTACTCCGCGTATTAGAAG
CTTATCCTGATCTAAGGCT -> TTATCCTGATCTAAGGCTT
CTTATTGCCACGAAGACTA -> TTATTGCCACGAAGACTAA
CTTCAACCCTGCATGACGG -> TTCAACCCTGCATGACGGA
CTTCACACGCAAGACCAAG -> TTCACACGCAAGACCAAGA
CTTCAGAGTAGACTTATCC -> TTCAGAGTAGACTTATCCT
CTTCATTTCGCTTTGACAG -> TTCATTTCGCTTTGACAGT
CTTCCCAAGGTACGGGTAT -> TTCCCAAGGTACGGGTATA
CTTCCCGCATCTCAGCAGA -> TTCCCGCATCTCAGCAGAG
CTTCCCGGCGGAAAATGAC -> TTCCCGGCGGAAAATGACT
CTTCTCTAAACCCTGGAGG -> TTCTCTAAACCCTGGAGGT
CTTGAACACGTCTGATCAA -> TTGAACACGTCTGATCAAG
CTTGAAGGCGTTAACCATG -> TTGAAGGCGTTAACCATGG
CTTGACGCATTTGCGTGCC -> TTGACGCATTTGCGTGCCA
CTTGACGGTAAGGCGATCC -> TTGACGGTAAGGCGATCCC
CTTGAGTGTGGTGTGTGAT -> TTGAGTGTGGTGTGTGATG
CTTGGCTTGTAAAGAGGTG -> TTGGCTTGTAAAGAGGTGT
CTTGTAAAGAGGTGTATAA -> TTGTAAAGAGGTGTATAAC
CTTGTGGTGTCAATTAGGG -> TTGTGGTGTCAATTAGGGC
CTTGTTAGGAAGAATCATA -> TTGTTAGGAAGAATCATAT
CTTGTTATACCTTAATCCT -> TTGTTATACCTTAATCCTC
CTTTAAAGATGATTTTACC -> TTTAAAGATGATTTTACCC
CTTTAATCCTTCCCGCATC -> TTTAATCCTTCCCGCATCT
CTTTACAACGTCTAACTCT -> TTTACAACGTCTAACTCTA
CTTTACTGAAAATGACTAT -> TTTACTGAAAATGACTATG
CTTTGACAGTGGGATGTGT -> TTTGACAGTGGGATGTGTT
CTTTGGATTCTCAGCCAAC -> TTTGGATTCTCAGCCAACC
CTTTGGTGGTGCCGTTAAC -> TTTGGTGGTGCCGTTAACT
CTTTGGTTGCCAGGGACAA -> TTTGGTTGCCAGGGACAAG
CTTTTTTAGCGCAAGGGTA -> TTTTTTAGCGCAAGGGTAC
GAAAATGACTATGACGGCA -> AAAATGACTATGACGGCAA
GAAAATGACTATGACGGCC -> AAAATGACTATGACGGCCG
GAAAATGACTATGACGGCG -> AAAATGACTATGACGGCGA
GAAAATGACTATGACGGCT -> AAAATGACTATGACGGCTG
GAAAATGTAGCCTTGTTAG -> AAAATGTAGCCTTGTTAGG
GAAACCAGAACCGCACGAC -> AAACCAGAACCGCACGACT
GAAACCGGCCGTGCGGGGT -> AAACCGGCCGTGCGGGGTA
GAAACGGGTCACTCGGATC -> AAACGGGTCACTCGGATCA
GAAACTTCCCAAGGTACGG -> AAACTTCCCAAGGTACGGG
GAAAGCTGATGAAGGTATG -> AAAGCTGATGAAGGTATGG
GAAATGCCGAGCCCTTGTT -> AAATGCCGAGCCCTTGTTA
GAAATTAGCTTCTCTAAAC -> AAATTAGCTTCTCTAAACC
GAACACACAGGATGCCGGT -> AACACACAGGATGCCGGTT
GAACACGTCTGATCAAGTG -> AACACGTCTGATCAAGTGG
GAACCGCACGACTCTGCAA -> AACCGCACGACTCTGCAAA
GAACTGCCTTATTGCCACG -> AACTGCCTTATTGCCACGA
GAAGAATCATATTGCCCGG -> AAGAATCATATTGCCCGGT
GAAGACTAACTTCACACGC -> AAGACTAACTTCACACGCA
GAAGAGGGTTTCCTCTCTT -> AAGAGGGTTTCCTCTCTTT
GAAGCCCCTGGCAATAGAA -> AAGCCCCTGGCAATAGAAA
GAAGGCGTTAACCATGGTG -> AAGGCGTTAACCATGGTGC
GAAGGGGCCGACGCACACA -> AAGGGGCCGACGCACACAA
GAAGGTATGGTAGTATGGA -> AAGGTATGGTAGTATGGAG
GAAGTGTATCTGGCGGATA -> AAGTGTATCTGGCGGATAC
GAATACAACCGCTGGCAAG -> AATACAACCGCTGGCAAGG
GAATATCACTACAGAAAAT -> AATATCACTACAGAAAATG
GAATCATATTGCCCGGTTA -> AATCATATTGCCCGGTTAC
GAATGTAATTGGTGAGACG -> AATGTAATTGGTGAGACGC
GAATTTAAGAAACCAGAAC -> AATTTAAGAAACCAGAACC
GACAAAGAGCCTGGCACCC -> ACAAAGAGCCTGGCACCCG
GACAACCAAACACGCAGCC -> ACAACCAAACACGCAGCCA
GACAAGATGCACGTTCGAG -> ACAAGATGCACGTTCGAGG
GACACAAAAGGGTAGGTAT -> ACACAAAAGGGTAGGTATG
GACACCAGTACCGCTCGAC -> ACACCAGTACCGCTCGACA
GACACTATACGGGTTCCAT -> ACACTATACGGGTTCCATG
GACACTCTCTCTTGAACAC -> ACACTCTCTCTTGAACACG
GACACTTTAAAGATGATTT -> ACACTTTAAAGATGATTTT
GACAGATGCAAGGACGTTT -> ACAGATGCAAGGACGTTTG
GACAGGCTATCTCAACGTA -> ACAGGCTATCTCAACGTAG
GACAGTGCGCTCTGCGGGG -> ACAGTGCGCTCTGCGGGGG
GACAGTGGGATGTGTTCAC -> ACAGTGGGATGTGTTCACG
GACCAAGAAACGGGTCACT -> ACCAAGAAACGGGTCACTC
GACCAAGGTTCTAGACTGT -> ACCAAGGTTCTAGACTGTT
GACCAGGGTTACGGCAGAC -> ACCAGGGTTACGGCAGACT
GACCCAGCTTAATCACTTC -> ACCCAGCTTAATCACTTCA
GACCCGTGCCGCCCTCGAG -> ACCCGTGCCGCCCTCGAGG
GACCCTACGCGCTGTGGTC -> ACCCTACGCGCTGTGGTCG
GACCGGAGGAACACACAGG -> ACCGGAGGAACACACAGGA
GACGCACACAATTTAACGG -> ACGCACACAATTTAACGGG
GACGCATTTGCGTGCCAAG -> ACGCATTTGCGTGCCAAGT
GACGCTATTTCCAATACCT -> ACGCTATTTCCAATACCTC
GACGGAAACTTCCCAAGGT -> ACGGAAACTTCCCAAGGTA
GACGGCAATTCCCAACGAG -> ACGGCAATTCCCAACGAGG
GACGGCCGCGTTGGGATAG -> ACGGCCGCGTTGGGATAGG
GACGGCGAGTCGTGTACAG -> ACGGCGAGTCGTGTACAGG
GACGGCTGGCGAGACGTAG -> ACGGCTGGCGAGACGTAGG
GACGGTAAGGCGATCCCGC -> ACGGTAAGGCGATCCCGCC
GACGTAGGACGTGGTCATC -> ACGTAGGACGTGGTCATCG
GACGTGGTCATCGGACAAC -> ACGTGGTCATCGGACAACC
GACGTGGTCATCGGACACC -> ACGTGGTCATCGGACACCA
GACGTGGTCATCGGACAGG -> ACGTGGTCATCGGACAGGC
GACGTGGTCATCGGACAGT -> ACGTGGTCATCGGACAGTG
GACGTGGTGATGAGGATTT -> ACGTGGTGATGAGGATTTC
GACGTTTGTCAACTCATAC -> ACGTTTGTCAACTCATACG
GACTAACTTCACACGCAAG -> ACTAACTTCACACGCAAGA
GACTATGACGGCAATTCCC -> ACTATGACGGCAATTCCCA
GACTATGACGGCCGCGTTG -> ACTATGACGGCCGCGTTGG
GACTATGACGGCGAGTCGT -> ACTATGACGGCGAGTCGTG
GACTATGACGGCTGGCGAG -> ACTATGACGGCTGGCGAGA
GACTCAGAATTTAAGAAAC -> ACTCAGAATTTAAGAAACC
GACTCTATCCCTTTAATCC -> ACTCTATCCCTTTAATCCT
GACTCTCAGATGCCATCTG -> ACTCTCAGATGCCATCTGG
GACTCTGCAAAACATCGTC -> ACTCTGCAAAACATCGTCC
GACTGATTCGCAGCTTCCC -> ACTGATTCGCAGCTTCCCG
GACTGTTCTGCCACTTGTG -> ACTGTTCTGCCACTTGTGG
GACTTATCCTGATCTAAGG -> ACTTATCCTGATCTAAGGC
GACTTTACAACGTCTAACT -> ACTTTACAACGTCTAACTC
GAGACGCTATTTCCAATAC -> AGACGCTATTTCCAATACC
GAGACGTAGGACGTGGTCA -> AGACGTAGGACGTGGTCAT
GAGAGTGTTGTATGGACAC -> AGAGTGTTGTATGGACACT
GAGATGAGTTCCAAATCAT -> AGATGAGTTCCAAATCATC
GAGATGGTATACTATATTC -> AGATGGTATACTATATTCT
GAGATTGGCTTCAACCCTG -> AGATTGGCTTCAACCCTGC
GAGCCAATGCTTGAAGGCG -> AGCCAATGCTTGAAGGCGT
GAGCCAGTTTCGACTGATT -> AGCCAGTTTCGACTGATTC
GAGCCCTTGTTATACCTTA -> AGCCCTTGTTATACCTTAA
GAGCCTCGTACTTACTCCG -> AGCCTCGTACTTACTCCGC
GAGCCTGGCACCCGACCAG -> AGCCTGGCACCCGACCAGG
GAGCGCGTCGTAAAACCTT -> AGCGCGTCGTAAAACCTTA
GAGGAAATGCCGAGCCCTT -> AGGAAATGCCGAGCCCTTG
GAGGAACACACAGGATGCC -> AGGAACACACAGGATGCCG
GAGGACCCTACGCGCTGTG -> AGGACCCTACGCGCTGTGG
GAGGACGTGGTCATCGGAC -> AGGACGTGGTCATCGGACA
GAGGATGGGTCCGAACTGC -> AGGATGGGTCCGAACTGCC
GAGGATTTCCTGGGCTAAC -> AGGATTTCCTGGGCTAACC
GAGGCCAAGGGAGTATCAG -> AGGCCAAGGGAGTATCAGT
GAGGCCGCCGACACAAAAG -> AGGCCGCCGACACAAAAGG
GAGGCGAATACAACCGCTG -> AGGCGAATACAACCGCTGG
GAGGCTCTTTTTTAGCGCA -> AGGCTCTTTTTTAGCGCAA
GAGGGTATTCATTTCAGAC -> AGGGTATTCATTTCAGACA
GAGGGTGCGTAAACAATTA -> AGGGTGCGTAAACAATTAA
GAGGGTTTCCTCTCTTTGG -> AGGGTTTCCTCTCTTTGGT
GAGGTGGCCAATCGGGTCC -> AGGTGGCCAATCGGGTCCC
GAGGTGTATAACCCTGCAA -> AGGTGTATAACCCTGCAAT
GAGTAGACTTATCCTGATC -> AGTAGACTTATCCTGATCT
GAGTATCAGTGGCAACCGT -> AGTATCAGTGGCAACCGTC
GAGTCGTGTACAGGACGTG -> AGTCGTGTACAGGACGTGG
GAGTGTGGTGTGTGATGTA -> AGTGTGGTGTGTGATGTAC
GAGTGTTGTATGGACACTC -> AGTGTTGTATGGACACTCT
GAGTTCCAAATCATCTTGG -> AGTTCCAAATCATCTTGGC
GAGTTTTCGTGACAGATGC -> AGTTTTCGTGACAGATGCA
GATAACGCAAGTGTGAGCC -> ATAACGCAAGTGTGAGCCT
GATACTTAACAATGGAAGG -> ATACTTAACAATGGAAGGG
GATAGCAGAGATTGGCTTC -> ATAGCAGAGATTGGCTTCA
GATAGCTACTTCAGAGTAG -> ATAGCTACTTCAGAGTAGA
GATAGGACGTGGTCATCGG -> ATAGGACGTGGTCATCGGA
GATAGGGTTTGCTGATGGA -> ATAGGGTTTGCTGATGGAA
GATCAAGTGGAGGACCCTA -> ATCAAGTGGAGGACCCTAC
GATCAATTTACTCACTATA -> ATCAATTTACTCACTATAT
GATCACTACCGCGGTTCCA -> ATCACTACCGCGGTTCCAT
GATCCACCTTGACGGTAAG -> ATCCACCTTGACGGTAAGG
GATCCCGCCGTCAGCGCAA -> ATCCCGCCGTCAGCGCAAG
GATCTAAGGCTTGACGCAT -> ATCTAAGGCTTGACGCATT
GATCTCGACTCTCAGATGC -> ATCTCGACTCTCAGATGCC
GATCTTGAGTGTGGTGTGT -> ATCTTGAGTGTGGTGTGTG
GATGAAGGTATGGTAGTAT -> ATGAAGGTATGGTAGTATG
GATGAATATCACTACAGAA -> ATGAATATCACTACAGAAA
GATGAGGATTTCCTGGGCT -> ATGAGGATTTCCTGGGCTA
GATGAGTTCCAAATCATCT -> ATGAGTTCCAAATCATCTT
GATGATTTTACCCTCGGCC -> ATGATTTTACCCTCGGCCT
GATGCAAGGACGTTTGTCA -> ATGCAAGGACGTTTGTCAA
GATGCACGTTCGAGGCTCT -> ATGCACGTTCGAGGCTCTT
GATGCCATCTGGACGTGGT -> ATGCCATCTGGACGTGGTG
GATGCCGGTTAGTCGCGCA -> ATGCCGGTTAGTCGCGCAA
GATGGAAGAGGGTTTCCTC -> ATGGAAGAGGGTTTCCTCT
GATGGGTCCGAACTGCCTT -> ATGGGTCCGAACTGCCTTA
GATGGTATACTATATTCTA -> ATGGTATACTATATTCTAT
GATGTACCTATCGCGTACT -> ATGTACCTATCGCGTACTA
GATGTGTTCACGCAACCGC -> ATGTGTTCACGCAACCGCC
GATGTTTCTCATAGAGCCA -> ATGTTTCTCATAGAGCCAA
GATTCGCAGCTTCCCGGCG -> ATTCGCAGCTTCCCGGCGG
GATTCTCAGCCAACCTAAC -> ATTCTCAGCCAACCTAACC
GATTGGCTTCAACCCTGCA -> ATTGGCTTCAACCCTGCAT
GATTTCCTGGGCTAACCTC -> ATTTCCTGGGCTAACCTCT
GATTTTACCCTCGGCCTGT -> ATTTTACCCTCGGCCTGTC
GCAAAACATCGTCCGAAAA -> CAAAACATCGTCCGAAAAT
GCAACCGCCCGGCACTCCC -> CAACCGCCCGGCACTCCCA
GCAACCGTCATAGATCTCG -> CAACCGTCATAGATCTCGA
GCAAGACCAAGAAACGGGT -> CAAGACCAAGAAACGGGTC
GCAAGAGGGTATTCATTTC -> CAAGAGGGTATTCATTTCA
GCAAGCCCGTCGATAGGGT -> CAAGCCCGTCGATAGGGTT
GCAAGGACGTTTGTCAACT -> CAAGGACGTTTGTCAACTC
GCAAGGGTACGCTACGCGA -> CAAGGGTACGCTACGCGAT
GCAAGGTTTGTTTATCTGG -> CAAGGTTTGTTTATCTGGC
GCAAGTGGACCAAGGTTCT -> CAAGTGGACCAAGGTTCTA
GCAAGTGTGAGCCTCGTAC -> CAAGTGTGAGCCTCGTACT
GCAATAGAAACCGGCCGTG -> CAATAGAAACCGGCCGTGC
GCAATAGGCAATGCCGACC -> CAATAGGCAATGCCGACCC
GCAATCGCCAGGCTCGTGG -> CAATCGCCAGGCTCGTGGA
GCAATGCCGACCCAGCTTA -> CAATGCCGACCCAGCTTAA
GCAATTCAAATGCCCGCGT -> CAATTCAAATGCCCGCGTT
GCAATTCCCAACGAGGACG -> CAATTCCCAACGAGGACGT
GCACACAATTTAACGGGAC -> CACACAATTTAACGGGACA
GCACACATCTGAGCCAGTT -> CACACATCTGAGCCAGTTT
GCACCCGACCAGGGTTACG -> CACCCGACCAGGGTTACGG
GCACGACTCTGCAAAACAT -> CACGACTCTGCAAAACATC
GCACGTCTGATGAATATCA -> CACGTCTGATGAATATCAC
GCACGTTCGAGGCTCTTTT -> CACGTTCGAGGCTCTTTTT
GCACGTTGCAGTGAGGCCA -> CACGTTGCAGTGAGGCCAA
GCACTCCCATGCCCCCGCA -> CACTCCCATGCCCCCGCAC
GCAGACTTTACAACGTCTA -> CAGACTTTACAACGTCTAA
GCAGAGAGTGTTGTATGGA -> CAGAGAGTGTTGTATGGAC
GCAGAGATTGGCTTCAACC -> CAGAGATTGGCTTCAACCC
GCAGAGGATGGGTCCGAAC -> CAGAGGATGGGTCCGAACT
GCAGCCAGCCCGCCAAACG -> CAGCCAGCCCGCCAAACGT
GCAGCTTCCCGGCGGAAAA -> CAGCTTCCCGGCGGAAAAT
GCAGTGAGGCCAAGGGAGT -> CAGTGAGGCCAAGGGAGTA
GCATCTCAGCAGAGGATGG -> CATCTCAGCAGAGGATGGG
GCATGACGGAAACTTCCCA -> CATGACGGAAACTTCCCAA
GCATGGGGGCGCTGGTATG -> CATGGGGGCGCTGGTATGA
GCATTTGCGTGCCAAGTCT -> CATTTGCGTGCCAAGTCTG
GCATTTGTCTCGGTTAGAT -> CATTTGTCTCGGTTAGATA
GCCAAACGTATCTGCTTTG -> CCAAACGTATCTGCTTTGG
GCCAACCTAACCATCTAAA -> CCAACCTAACCATCTAAAT
GCCAAGGGAGTATCAGTGG -> CCAAGGGAGTATCAGTGGC
GCCAAGTCTGCTATTGAAA -> CCAAGTCTGCTATTGAAAG
GCCAATCGGGTCCCAGAGA -> CCAATCGGGTCCCAGAGAT
GCCAATGCTTGAAGGCGTT -> CCAATGCTTGAAGGCGTTA
GCCACGAAGACTAACTTCA -> CCACGAAGACTAACTTCAC
GCCACTTGTGGTGTCAATT -> CCACTTGTGGTGTCAATTA
GCCAGCCCGCCAAACGTAT -> CCAGCCCGCCAAACGTATC
GCCAGGCTCGTGGAATGTA -> CCAGGCTCGTGGAATGTAA
GCCAGGGACAAGATGCACG -> CCAGGGACAAGATGCACGT
GCCAGTTTCGACTGATTCG -> CCAGTTTCGACTGATTCGC
GCCATCTGGACGTGGTGAT -> CCATCTGGACGTGGTGATG
GCCCCCGCACGTTGCAGTG -> CCCCCGCACGTTGCAGTGA
GCCCCTGGCAATAGAAACC -> CCCCTGGCAATAGAAACCG
GCCCGCCAAACGTATCTGC -> CCCGCCAAACGTATCTGCT
GCCCGCGTTCTCAAGTCCC -> CCCGCGTTCTCAAGTCCCG
GCCCGGCACTCCCATGCCC -> CCCGGCACTCCCATGCCCC
GCCCGGTTACACCCCTCTT -> CCCGGTTACACCCCTCTTT
GCCCGTCGATAGGGTTTGC -> CCCGTCGATAGGGTTTGCT
GCCCTCGAGGGTGCGTAAA -> CCCTCGAGGGTGCGTAAAC
GCCCTTGTTATACCTTAAT -> CCCTTGTTATACCTTAATC
GCCGACACAAAAGGGTAGG -> CCGACACAAAAGGGTAGGT
GCCGACCCAGCTTAATCAC -> CCGACCCAGCTTAATCACT
GCCGACGCACACAATTTAA -> CCGACGCACACAATTTAAC
GCCGAGCCCTTGTTATACC -> CCGAGCCCTTGTTATACCT
GCCGCCCTCGAGGGTGCGT -> CCGCCCTCGAGGGTGCGTA
GCCGCCGACACAAAAGGGT -> CCGCCGACACAAAAGGGTA
GCCGCGTTGGGATAGGACG -> CCGCGTTGGGATAGGACGT
GCCGGTTAGTCGCGCAAGT -> CCGGTTAGTCGCGCAAGTG
GCCGTCAGCGCAAGAGGGT -> CCGTCAGCGCAAGAGGGTA
GCCGTGCGGGGTAGAGCGC -> CCGTGCGGGGTAGAGCGCG
GCCGTTAACTGACCGGAGG -> CCGTTAACTGACCGGAGGA
GCCTCGTACTTACTCCGCG -> CCTCGTACTTACTCCGCGT
GCCTGGCACCCGACCAGGG -> CCTGGCACCCGACCAGGGT
GCCTGTCTAGAGGAAATGC -> CCTGTCTAGAGGAAATGCC
GCCTTATTGCCACGAAGAC -> CCTTATTGCCACGAAGACT
GCCTTGTTAGGAAGAATCA -> CCTTGTTAGGAAGAATCAT
GCGAATACAACCGCTGGCA -> CGAATACAACCGCTGGCAA
GCGACTGCGCCAGCGTGTG -> CGACTGCGCCAGCGTGTGT
GCGAGACGTAGGACGTGGT -> CGAGACGTAGGACGTGGTC
GCGAGTCGTGTACAGGACG -> CGAGTCGTGTACAGGACGT
GCGATAGCTACTTCAGAGT -> CGATAGCTACTTCAGAGTA
GCGATCCACCTTGACGGTA -> CGATCCACCTTGACGGTAA
GCGATCCCGCCGTCAGCGC -> CGATCCCGCCGTCAGCGCA
GCGCAAGAGGGTATTCATT -> CGCAAGAGGGTATTCATTT
GCGCAAGGGTACGCTACGC -> CGCAAGGGTACGCTACGCG
GCGCAAGTGGACCAAGGTT -> CGCAAGTGGACCAAGGTTC
GCGCGTCGTAAAACCTTAC -> CGCGTCGTAAAACCTTACA
GCGCTCTGCGGGGGATCAA -> CGCTCTGCGGGGGATCAAT
GCGCTGGTATGATCTTGAG -> CGCTGGTATGATCTTGAGT
GCGCTGTGGTCGGAGGCCG -> CGCTGTGGTCGGAGGCCGC
GCGGAAAATGACTATGACG -> CGGAAAATGACTATGACGG
GCGGATACTTAACAATGGA -> CGGATACTTAACAATGGAA
GCGGGGGATCAATTTACTC -> CGGGGGATCAATTTACTCA
GCGGGGGTTGGGCATGGGG -> CGGGGGTTGGGCATGGGGG
GCGGGGTAGAGCGCGTCGT -> CGGGGTAGAGCGCGTCGTA
GCGGTTCCATGATAACGCA -> CGGTTCCATGATAACGCAA
GCGTAAACAATTAATTATC -> CGTAAACAATTAATTATCG
GCGTACTATAGCTGTGCAC -> CGTACTATAGCTGTGCACA
GCGTATTAGAAGTGTATCT -> CGTATTAGAAGTGTATCTG
GCGTCGTAAAACCTTACAG -> CGTCGTAAAACCTTACAGT
GCGTGCCAAGTCTGCTATT -> CGTGCCAAGTCTGCTATTG
GCGTGTACAGTTATGCGAT -> CGTGTACAGTTATGCGATC
GCGTTAACCATGGTGCAAT -> CGTTAACCATGGTGCAATC
GCGTTCTCAAGTCCCGACC -> CGTTCTCAAGTCCCGACCC
GCGTTGGGATAGGACGTGG -> CGTTGGGATAGGACGTGGT
GCGTTTCTGAGGCGAATAC -> CGTTTCTGAGGCGAATACA
GCTAACCTCTCTACGAAAT -> CTAACCTCTCTACGAAATT
GCTAATCCTTAATAAAAGT -> CTAATCCTTAATAAAAGTA
GCTACGCGATAGCTACTTC -> CTACGCGATAGCTACTTCA
GCTACTTCAGAGTAGACTT -> CTACTTCAGAGTAGACTTA
GCTATCTCAACGTAGGTCA -> CTATCTCAACGTAGGTCAT
GCTATTGAAAGCTGATGAA -> CTATTGAAAGCTGATGAAG
GCTATTTCCAATACCTCCG -> CTATTTCCAATACCTCCGT
GCTCGACAAAGAGCCTGGC -> CTCGACAAAGAGCCTGGCA
GCTCGTGGAATGTAATTGG -> CTCGTGGAATGTAATTGGT
GCTCTGCGGGGGATCAATT -> CTCTGCGGGGGATCAATTT
GCTCTTTTTTAGCGCAAGG -> CTCTTTTTTAGCGCAAGGG
GCTGATGAAGGTATGGTAG -> CTGATGAAGGTATGGTAGT
GCTGATGGAAGAGGGTTTC -> CTGATGGAAGAGGGTTTCC
GCTGCGACTGCGCCAGCGT -> CTGCGACTGCGCCAGCGTG
GCTGGCAAGGTTTGTTTAT -> CTGGCAAGGTTTGTTTATC
GCTGGCGAGACGTAGGACG -> CTGGCGAGACGTAGGACGT
GCTGGTATGATCTTGAGTG -> CTGGTATGATCTTGAGTGT
GCTGTGCACACATCTGAGC -> CTGTGCACACATCTGAGCC
GCTGTGGTCGGAGGCCGCC -> CTGTGGTCGGAGGCCGCCG
GCTTAATCACTTCATTTCG -> CTTAATCACTTCATTTCGC
GCTTCAACCCTGCATGACG -> CTTCAACCCTGCATGACGG
GCTTCCCGGCGGAAAATGA -> CTTCCCGGCGGAAAATGAC
GCTTCTCTAAACCCTGGAG -> CTTCTCTAAACCCTGGAGG
GCTTGAAGGCGTTAACCAT -> CTTGAAGGCGTTAACCATG
GCTTGACGCATTTGCGTGC -> CTTGACGCATTTGCGTGCC
GCTTGTAAAGAGGTGTATA -> CTTGTAAAGAGGTGTATAA
GCTTTACTGAAAATGACTA -> CTTTACTGAAAATGACTAT
GCTTTGACAGTGGGATGTG -> CTTTGACAGTGGGATGTGT
GCTTTGGTTGCCAGGGACA -> CTTTGGTTGCCAGGGACAA
GGAAAATGACTATGACGGC -> GAAAATGACTATGACGGCG
GGAAAATGTAGCCTTGTTA -> GAAAATGTAGCCTTGTTAG
GGAAACTTCCCAAGGTACG -> GAAACTTCCCAAGGTACGG
GGAAATGCCGAGCCCTTGT -> GAAATGCCGAGCCCTTGTT
GGAACACACAGGATGCCGG -> GAACACACAGGATGCCGGT
GGAAGAATCATATTGCCCG -> GAAGAATCATATTGCCCGG
GGAAGAGGGTTTCCTCTCT -> GAAGAGGGTTTCCTCTCTT
GGAAGCCCCTGGCAATAGA -> GAAGCCCCTGGCAATAGAA
GGAAGGGGCCGACGCACAC -> GAAGGGGCCGACGCACACA
GGAATGTAATTGGTGAGAC -> GAATGTAATTGGTGAGACG
GGACAACCAAACACGCAGC -> GACAACCAAACACGCAGCC
GGACAAGATGCACGTTCGA -> GACAAGATGCACGTTCGAG
GGACACCAGTACCGCTCGA -> GACACCAGTACCGCTCGAC
GGACACTCTCTCTTGAACA -> GACACTCTCTCTTGAACAC
GGACACTTTAAAGATGATT -> GACACTTTAAAGATGATTT
GGACAGGCTATCTCAACGT -> GACAGGCTATCTCAACGTA
GGACAGTGCGCTCTGCGGG -> GACAGTGCGCTCTGCGGGG
GGACCAAGGTTCTAGACTG -> GACCAAGGTTCTAGACTGT
GGACCCTACGCGCTGTGGT -> GACCCTACGCGCTGTGGTC
GGACGTGGTCATCGGACAA -> GACGTGGTCATCGGACAAC
GGACGTGGTCATCGGACAC -> GACGTGGTCATCGGACACC
GGACGTGGTCATCGGACAG -> GACGTGGTCATCGGACAGG,GACGTGGTCATCGGACAGT
GGACGTGGTGATGAGGATT -> GACGTGGTGATGAGGATTT
GGACGTTTGTCAACTCATA -> GACGTTTGTCAACTCATAC
GGAGATGGTATACTATATT -> GAGATGGTATACTATATTC
GGAGGAACACACAGGATGC -> GAGGAACACACAGGATGCC
GGAGGACCCTACGCGCTGT -> GAGGACCCTACGCGCTGTG
GGAGGCCGCCGACACAAAA -> GAGGCCGCCGACACAAAAG
GGAGGTGGCCAATCGGGTC -> GAGGTGGCCAATCGGGTCC
GGAGTATCAGTGGCAACCG -> GAGTATCAGTGGCAACCGT
GGATACTTAACAATGGAAG -> GATACTTAACAATGGAAGG
GGATAGGACGTGGTCATCG -> GATAGGACGTGGTCATCGG
GGATCAATTTACTCACTAT -> GATCAATTTACTCACTATA
GGATCACTACCGCGGTTCC -> GATCACTACCGCGGTTCCA
GGATGCCGGTTAGTCGCGC -> GATGCCGGTTAGTCGCGCA
GGATGGGTCCGAACTGCCT -> GATGGGTCCGAACTGCCTT
GGATGTGTTCACGCAACCG -> GATGTGTTCACGCAACCGC
GGATTCTCAGCCAACCTAA -> GATTCTCAGCCAACCTAAC
GGATTTCCTGGGCTAACCT -> GATTTCCTGGGCTAACCTC
GGCAACCGTCATAGATCTC -> GCAACCGTCATAGATCTCG
GGCAAGCCCGTCGATAGGG -> GCAAGCCCGTCGATAGGGT
GGCAAGGTTTGTTTATCTG -> GCAAGGTTTGTTTATCTGG
GGCAATAGAAACCGGCCGT -> GCAATAGAAACCGGCCGTG
GGCAATGCCGACCCAGCTT -> GCAATGCCGACCCAGCTTA
GGCAATTCCCAACGAGGAC -> GCAATTCCCAACGAGGACG
GGCACCCGACCAGGGTTAC -> GCACCCGACCAGGGTTACG
GGCACTCCCATGCCCCCGC -> GCACTCCCATGCCCCCGCA
GGCAGACTTTACAACGTCT -> GCAGACTTTACAACGTCTA
GGCATGGGGGCGCTGGTAT -> GCATGGGGGCGCTGGTATG
GGCATTTGTCTCGGTTAGA -> GCATTTGTCTCGGTTAGAT
GGCCAAGGGAGTATCAGTG -> GCCAAGGGAGTATCAGTGG
GGCCAATCGGGTCCCAGAG -> GCCAATCGGGTCCCAGAGA
GGCCGACGCACACAATTTA -> GCCGACGCACACAATTTAA
GGCCGCCGACACAAAAGGG -> GCCGCCGACACAAAAGGGT
GGCCGCGTTGGGATAGGAC -> GCCGCGTTGGGATAGGACG
GGCCGTGCGGGGTAGAGCG -> GCCGTGCGGGGTAGAGCGC
GGCCTGTCTAGAGGAAATG -> GCCTGTCTAGAGGAAATGC
GGCGAATACAACCGCTGGC -> GCGAATACAACCGCTGGCA
GGCGAGACGTAGGACGTGG -> GCGAGACGTAGGACGTGGT
GGCGAGTCGTGTACAGGAC -> GCGAGTCGTGTACAGGACG
GGCGATCCCGCCGTCAGCG -> GCGATCCCGCCGTCAGCGC
GGCGCTGGTATGATCTTGA -> GCGCTGGTATGATCTTGAG
GGCGGAAAATGACTATGAC -> GCGGAAAATGACTATGACG
GGCGGATACTTAACAATGG -> GCGGATACTTAACAATGGA
GGCGGGGGTTGGGCATGGG -> GCGGGGGTTGGGCATGGGG
GGCGTTAACCATGGTGCAA -> GCGTTAACCATGGTGCAAT
GGCTAACCTCTCTACGAAA -> GCTAACCTCTCTACGAAAT
GGCTATCTCAACGTAGGTC -> GCTATCTCAACGTAGGTCA
GGCTCGTGGAATGTAATTG -> GCTCGTGGAATGTAATTGG
GGCTCTTTTTTAGCGCAAG -> GCTCTTTTTTAGCGCAAGG
GGCTGGCGAGACGTAGGAC -> GCTGGCGAGACGTAGGACG
GGCTTCAACCCTGCATGAC -> GCTTCAACCCTGCATGACG
GGCTTGACGCATTTGCGTG -> GCTTGACGCATTTGCGTGC
GGCTTGTAAAGAGGTGTAT -> GCTTGTAAAGAGGTGTATA
GGGACAAGATGCACGTTCG -> GGACAAGATGCACGTTCGA
GGGACACTTTAAAGATGAT -> GGACACTTTAAAGATGATT
GGGAGTATCAGTGGCAACC -> GGAGTATCAGTGGCAACCG
GGGATAGGACGTGGTCATC -> GGATAGGACGTGGTCATCG
GGGATCAATTTACTCACTA -> GGATCAATTTACTCACTAT
GGGATGTGTTCACGCAACC -> GGATGTGTTCACGCAACCG
GGGCATGGGGGCGCTGGTA -> GGCATGGGGGCGCTGGTAT
GGGCCGACGCACACAATTT -> GGCCGACGCACACAATTTA
GGGCGCTGGTATGATCTTG -> GGCGCTGGTATGATCTTGA
GGGCGGGGGTTGGGCATGG -> GGCGGGGGTTGGGCATGGG
GGGCTAACCTCTCTACGAA -> GGCTAACCTCTCTACGAAA
GGGGATCAATTTACTCACT -> GGGATCAATTTACTCACTA
GGGGCCGACGCACACAATT -> GGGCCGACGCACACAATTT
GGGGCGCTGGTATGATCTT -> GGGCGCTGGTATGATCTTG
GGGGGATCAATTTACTCAC -> GGGGATCAATTTACTCACT
GGGGGCGCTGGTATGATCT -> GGGGCGCTGGTATGATCTT
GGGGGTTGGGCATGGGGGC -> GGGGTTGGGCATGGGGGCG
GGGGTAGAGCGCGTCGTAA -> GGGTAGAGCGCGTCGTAAA
GGGGTTGGGCATGGGGGCG -> GGGTTGGGCATGGGGGCGC
GGGTACGCTACGCGATAGC -> GGTACGCTACGCGATAGCT
GGGTAGAGCGCGTCGTAAA -> GGTAGAGCGCGTCGTAAAA
GGGTAGGTATGCGTGTACA -> GGTAGGTATGCGTGTACAG
GGGTATATTAGACTCTATC -> GGTATATTAGACTCTATCC
GGGTATTCATTTCAGACAC -> GGTATTCATTTCAGACACT
GGGTCACTCGGATCACTAC -> GGTCACTCGGATCACTACC
GGGTCCCAGAGATGAGTTC -> GGTCCCAGAGATGAGTTCC
GGGTCCGAACTGCCTTATT -> GGTCCGAACTGCCTTATTG
GGGTGCGTAAACAATTAAT -> GGTGCGTAAACAATTAATT
GGGTTACGGCAGACTTTAC -> GGTTACGGCAGACTTTACA
GGGTTCCATGCGTTTCTGA -> GGTTCCATGCGTTTCTGAG
GGGTTGGGCATGGGGGCGC -> GGTTGGGCATGGGGGCGCT
GGGTTTCCTCTCTTTGGTG -> GGTTTCCTCTCTTTGGTGG
GGGTTTGCTGATGGAAGAG -> GGTTTGCTGATGGAAGAGG
GGTAAGGCGATCCCGCCGT -> GTAAGGCGATCCCGCCGTC
GGTACGCTACGCGATAGCT -> GTACGCTACGCGATAGCTA
GGTACGGGTATATTAGACT -> GTACGGGTATATTAGACTC
GGTAGAGCGCGTCGTAAAA -> GTAGAGCGCGTCGTAAAAC
GGTAGGTATGCGTGTACAG -> GTAGGTATGCGTGTACAGT
GGTAGTATGGAGATGGTAT -> GTAGTATGGAGATGGTATA
GGTATACTATATTCTATGC -> GTATACTATATTCTATGCA
GGTATATTAGACTCTATCC -> GTATATTAGACTCTATCCC
GGTATGATCTTGAGTGTGG -> GTATGATCTTGAGTGTGGT
GGTATGCGTGTACAGTTAT -> GTATGCGTGTACAGTTATG
GGTATGGTAGTATGGAGAT -> GTATGGTAGTATGGAGATG
GGTATTCATTTCAGACACT -> GTATTCATTTCAGACACTA
GGTCACTCGGATCACTACC -> GTCACTCGGATCACTACCG
GGTCATCGGACAACCAAAC -> GTCATCGGACAACCAAACA
GGTCATCGGACACCAGTAC -> GTCATCGGACACCAGTACC
GGTCATCGGACAGGCTATC -> GTCATCGGACAGGCTATCT
GGTCATCGGACAGTGCGCT -> GTCATCGGACAGTGCGCTC
GGTCATGGAAAATGTAGCC -> GTCATGGAAAATGTAGCCT
GGTCCCAGAGATGAGTTCC -> GTCCCAGAGATGAGTTCCA
GGTCCGAACTGCCTTATTG -> GTCCGAACTGCCTTATTGC
GGTCGGAGGCCGCCGACAC -> GTCGGAGGCCGCCGACACA
GGTGAGACGCTATTTCCAA -> GTGAGACGCTATTTCCAAT
GGTGATGAGGATTTCCTGG -> GTGATGAGGATTTCCTGGG
GGTGCAATCGCCAGGCTCG -> GTGCAATCGCCAGGCTCGT
GGTGCCGTTAACTGACCGG -> GTGCCGTTAACTGACCGGA
GGTGCGTAAACAATTAATT -> GTGCGTAAACAATTAATTA
GGTGGCCAATCGGGTCCCA -> GTGGCCAATCGGGTCCCAG
GGTGGTGCCGTTAACTGAC -> GTGGTGCCGTTAACTGACC
GGTGTATAACCCTGCAATT -> GTGTATAACCCTGCAATTC
GGTGTCAATTAGGGCGGGG -> GTGTCAATTAGGGCGGGGG
GGTGTGTGATGTACCTATC -> GTGTGTGATGTACCTATCG
GGTTACACCCCTCTTTGGA -> GTTACACCCCTCTTTGGAT
GGTTACGGCAGACTTTACA -> GTTACGGCAGACTTTACAA
GGTTAGATAGCAGAGATTG -> GTTAGATAGCAGAGATTGG
GGTTAGTCGCGCAAGTGGA -> GTTAGTCGCGCAAGTGGAC
GGTTCCATGATAACGCAAG -> GTTCCATGATAACGCAAGT
GGTTCCATGCGTTTCTGAG -> GTTCCATGCGTTTCTGAGG
GGTTCTAGACTGTTCTGCC -> GTTCTAGACTGTTCTGCCA
GGTTGCCAGGGACAAGATG -> GTTGCCAGGGACAAGATGC
GGTTGGGCATGGGGGCGCT -> GTTGGGCATGGGGGCGCTG
GGTTTCCTCTCTTTGGTGG -> GTTTCCTCTCTTTGGTGGT
GGTTTGCTGATGGAAGAGG -> GTTTGCTGATGGAAGAGGG
GGTTTGTTTATCTGGCAAG -> GTTTGTTTATCTGGCAAGC
GTAAAACCTTACAGTGAGT -> TAAAACCTTACAGTGAGTT
GTAAACAATTAATTATCGC -> TAAACAATTAATTATCGCT
GTAAAGAGGTGTATAACCC -> TAAAGAGGTGTATAACCCT
GTAAGGCGATCCCGCCGTC -> TAAGGCGATCCCGCCGTCA
GTAATTGGTGAGACGCTAT -> TAATTGGTGAGACGCTATT
GTACAGGACGTGGTCATCG -> TACAGGACGTGGTCATCGG
GTACAGTTATGCGATCCAC -> TACAGTTATGCGATCCACC
GTACCGCTCGACAAAGAGC -> TACCGCTCGACAAAGAGCC
GTACCTATCGCGTACTATA -> TACCTATCGCGTACTATAG
GTACGCTACGCGATAGCTA -> TACGCTACGCGATAGCTAC
GTACGGGTATATTAGACTC -> TACGGGTATATTAGACTCT
GTACTATAGCTGTGCACAC -> TACTATAGCTGTGCACACA
GTACTTACTCCGCGTATTA -> TACTTACTCCGCGTATTAG
GTAGACTTATCCTGATCTA -> TAGACTTATCCTGATCTAA
GTAGAGCGCGTCGTAAAAC -> TAGAGCGCGTCGTAAAACC
GTAGCAGAGAGTGTTGTAT -> TAGCAGAGAGTGTTGTATG
GTAGCCTTGTTAGGAAGAA -> TAGCCTTGTTAGGAAGAAT
GTAGGACGTGGTCATCGGA -> TAGGACGTGGTCATCGGAC
GTAGGTATGCGTGTACAGT -> TAGGTATGCGTGTACAGTT
GTAGGTCATGGAAAATGTA -> TAGGTCATGGAAAATGTAG
GTAGTATGGAGATGGTATA -> TAGTATGGAGATGGTATAC
GTATAACCCTGCAATTCAA -> TATAACCCTGCAATTCAAA
GTATACTATATTCTATGCA -> TATACTATATTCTATGCAA
GTATATTAGACTCTATCCC -> TATATTAGACTCTATCCCT
GTATCAGTGGCAACCGTCA -> TATCAGTGGCAACCGTCAT
GTATCTGCTTTGGTTGCCA -> TATCTGCTTTGGTTGCCAG
GTATCTGGCGGATACTTAA -> TATCTGGCGGATACTTAAC
GTATGATCTTGAGTGTGGT -> TATGATCTTGAGTGTGGTG
GTATGCGTGTACAGTTATG -> TATGCGTGTACAGTTATGC
GTATGGACACTCTCTCTTG -> TATGGACACTCTCTCTTGA
GTATGGAGATGGTATACTA -> TATGGAGATGGTATACTAT
GTATGGTAGTATGGAGATG -> TATGGTAGTATGGAGATGG
GTATTAGAAGTGTATCTGG -> TATTAGAAGTGTATCTGGC
GTATTCATTTCAGACACTA -> TATTCATTTCAGACACTAT
GTCAACTCATACGCACGTC -> TCAACTCATACGCACGTCT
GTCAATTAGGGCGGGGGTT -> TCAATTAGGGCGGGGGTTG
GTCACTCGGATCACTACCG -> TCACTCGGATCACTACCGC
GTCAGCGCAAGAGGGTATT -> TCAGCGCAAGAGGGTATTC
GTCATAGATCTCGACTCTC -> TCATAGATCTCGACTCTCA
GTCATCGGACAACCAAACA -> TCATCGGACAACCAAACAC
GTCATCGGACACCAGTACC -> TCATCGGACACCAGTACCG
GTCATCGGACAGGCTATCT -> TCATCGGACAGGCTATCTC
GTCATCGGACAGTGCGCTC -> TCATCGGACAGTGCGCTCT
GTCATGGAAAATGTAGCCT -> TCATGGAAAATGTAGCCTT
GTCCCAGAGATGAGTTCCA -> TCCCAGAGATGAGTTCCAA
GTCCCGACCCGTGCCGCCC -> TCCCGACCCGTGCCGCCCT
GTCCGAAAATGACTATGAC -> TCCGAAAATGACTATGACG
GTCCGAACTGCCTTATTGC -> TCCGAACTGCCTTATTGCC
GTCGATAGGGTTTGCTGAT -> TCGATAGGGTTTGCTGATG
GTCGCGCAAGTGGACCAAG -> TCGCGCAAGTGGACCAAGG
GTCGGAGGCCGCCGACACA -> TCGGAGGCCGCCGACACAA
GTCGTAAAACCTTACAGTG -> TCGTAAAACCTTACAGTGA
GTCGTGTACAGGACGTGGT -> TCGTGTACAGGACGTGGTC
GTCTAACTCTAGATGTTTC -> TCTAACTCTAGATGTTTCT
GTCTAGAGGAAATGCCGAG -> TCTAGAGGAAATGCCGAGC
GTCTCGGTTAGATAGCAGA -> TCTCGGTTAGATAGCAGAG
GTCTGATCAAGTGGAGGAC -> TCTGATCAAGTGGAGGACC
GTCTGATGAATATCACTAC -> TCTGATGAATATCACTACA
GTCTGCTATTGAAAGCTGA -> TCTGCTATTGAAAGCTGAT
GTGACAGATGCAAGGACGT -> TGACAGATGCAAGGACGTT
GTGAGACGCTATTTCCAAT -> TGAGACGCTATTTCCAATA
GTGAGCCTCGTACTTACTC -> TGAGCCTCGTACTTACTCC
GTGAGGCCAAGGGAGTATC -> TGAGGCCAAGGGAGTATCA
GTGAGTTTTCGTGACAGAT -> TGAGTTTTCGTGACAGATG
GTGATGAGGATTTCCTGGG -> TGATGAGGATTTCCTGGGC
GTGATGTACCTATCGCGTA -> TGATGTACCTATCGCGTAC
GTGCAATCGCCAGGCTCGT -> TGCAATCGCCAGGCTCGTG
GTGCACACATCTGAGCCAG -> TGCACACATCTGAGCCAGT
GTGCCAAGTCTGCTATTGA -> TGCCAAGTCTGCTATTGAA
GTGCCGCCCTCGAGGGTGC -> TGCCGCCCTCGAGGGTGCG
GTGCCGTTAACTGACCGGA -> TGCCGTTAACTGACCGGAG
GTGCGCTCTGCGGGGGATC -> TGCGCTCTGCGGGGGATCA
GTGCGGGGTAGAGCGCGTC -> TGCGGGGTAGAGCGCGTCG
GTGCGTAAACAATTAATTA -> TGCGTAAACAATTAATTAT
GTGGAATGTAATTGGTGAG -> TGGAATGTAATTGGTGAGA
GTGGACCAAGGTTCTAGAC -> TGGACCAAGGTTCTAGACT
GTGGAGGACCCTACGCGCT -> TGGAGGACCCTACGCGCTG
GTGGCAACCGTCATAGATC -> TGGCAACCGTCATAGATCT
GTGGCCAATCGGGTCCCAG -> TGGCCAATCGGGTCCCAGA
GTGGGATGTGTTCACGCAA -> TGGGATGTGTTCACGCAAC
GTGGTCATCGGACAACCAA -> TGGTCATCGGACAACCAAA
GTGGTCATCGGACACCAGT -> TGGTCATCGGACACCAGTA
GTGGTCATCGGACAGGCTA -> TGGTCATCGGACAGGCTAT
GTGGTCATCGGACAGTGCG -> TGGTCATCGGACAGTGCGC
GTGGTCGGAGGCCGCCGAC -> TGGTCGGAGGCCGCCGACA
GTGGTGATGAGGATTTCCT -> TGGTGATGAGGATTTCCTG
GTGGTGCCGTTAACTGACC -> TGGTGCCGTTAACTGACCG
GTGGTGTCAATTAGGGCGG -> TGGTGTCAATTAGGGCGGG
GTGGTGTGTGATGTACCTA -> TGGTGTGTGATGTACCTAT
GTGTACAGGACGTGGTCAT -> TGTACAGGACGTGGTCATC
GTGTACAGTTATGCGATCC -> TGTACAGTTATGCGATCCA
GTGTATAACCCTGCAATTC -> TGTATAACCCTGCAATTCA
GTGTATCTGGCGGATACTT -> TGTATCTGGCGGATACTTA
GTGTCAATTAGGGCGGGGG -> TGTCAATTAGGGCGGGGGT
GTGTGAGCCTCGTACTTAC -> TGTGAGCCTCGTACTTACT
GTGTGATGTACCTATCGCG -> TGTGATGTACCTATCGCGT
GTGTGGTGTGTGATGTACC -> TGTGGTGTGTGATGTACCT
GTGTGTGATGTACCTATCG -> TGTGTGATGTACCTATCGC
GTGTTCACGCAACCGCCCG -> TGTTCACGCAACCGCCCGG
GTGTTGTATGGACACTCTC -> TGTTGTATGGACACTCTCT
GTTAACCATGGTGCAATCG -> TTAACCATGGTGCAATCGC
GTTAACTGACCGGAGGAAC -> TTAACTGACCGGAGGAACA
GTTACACCCCTCTTTGGAT -> TTACACCCCTCTTTGGATT
GTTACGGCAGACTTTACAA -> TTACGGCAGACTTTACAAC
GTTAGATAGCAGAGATTGG -> TTAGATAGCAGAGATTGGC
GTTAGGAAGAATCATATTG -> TTAGGAAGAATCATATTGC
GTTAGTCGCGCAAGTGGAC -> TTAGTCGCGCAAGTGGACC
GTTATACCTTAATCCTCTA -> TTATACCTTAATCCTCTAT
GTTATGCGATCCACCTTGA -> TTATGCGATCCACCTTGAC
GTTCACGCAACCGCCCGGC -> TTCACGCAACCGCCCGGCA
GTTCCAAATCATCTTGGCT -> TTCCAAATCATCTTGGCTT
GTTCCACAGGCATTTGTCT -> TTCCACAGGCATTTGTCTC
GTTCCATGATAACGCAAGT -> TTCCATGATAACGCAAGTG
GTTCCATGCGTTTCTGAGG -> TTCCATGCGTTTCTGAGGC
GTTCGAGGCTCTTTTTTAG -> TTCGAGGCTCTTTTTTAGC
GTTCTAGACTGTTCTGCCA -> TTCTAGACTGTTCTGCCAC
GTTCTCAAGTCCCGACCCG -> TTCTCAAGTCCCGACCCGT
GTTCTGCCACTTGTGGTGT -> TTCTGCCACTTGTGGTGTC
GTTGCAGTGAGGCCAAGGG -> TTGCAGTGAGGCCAAGGGA
GTTGCCAGGGACAAGATGC -> TTGCCAGGGACAAGATGCA
GTTGGGATAGGACGTGGTC -> TTGGGATAGGACGTGGTCA
GTTGGGCATGGGGGCGCTG -> TTGGGCATGGGGGCGCTGG
GTTGTATGGACACTCTCTC -> TTGTATGGACACTCTCTCT
GTTTATCTGGCAAGCCCGT -> TTTATCTGGCAAGCCCGTC
GTTTCCTCTCTTTGGTGGT -> TTTCCTCTCTTTGGTGGTG
GTTTCGACTGATTCGCAGC -> TTTCGACTGATTCGCAGCT
GTTTCTCATAGAGCCAATG -> TTTCTCATAGAGCCAATGC
GTTTCTGAGGCGAATACAA -> TTTCTGAGGCGAATACAAC
GTTTGCTGATGGAAGAGGG -> TTTGCTGATGGAAGAGGGT
GTTTGTCAACTCATACGCA -> TTTGTCAACTCATACGCAC
GTTTGTTTATCTGGCAAGC -> TTTGTTTATCTGGCAAGCC
GTTTTCGTGACAGATGCAA -> TTTTCGTGACAGATGCAAG
TAAAACCTTACAGTGAGTT -> AAAACCTTACAGTGAGTTT
TAAAAGTAGCAGAGAGTGT -> AAAAGTAGCAGAGAGTGTT
TAAACAATTAATTATCGCT -> AAACAATTAATTATCGCTT
TAAACCCTGGAGGTGGCCA -> AAACCCTGGAGGTGGCCAA
TAAAGAGGTGTATAACCCT -> AAAGAGGTGTATAACCCTG
TAAAGATGATTTTACCCTC -> AAAGATGATTTTACCCTCG
TAAATCTATTTGCTGCGAC -> AAATCTATTTGCTGCGACT
TAACAATGGAAGGGGCCGA -> AACAATGGAAGGGGCCGAC
TAACCATCTAAATCTATTT -> AACCATCTAAATCTATTTG
TAACCATGGTGCAATCGCC -> AACCATGGTGCAATCGCCA
TAACCCTGCAATTCAAATG -> AACCCTGCAATTCAAATGC
TAACCTCTCTACGAAATTA -> AACCTCTCTACGAAATTAG
TAACGCAAGTGTGAGCCTC -> AACGCAAGTGTGAGCCTCG
TAACGGGACACTTTAAAGA -> AACGGGACACTTTAAAGAT
TAACTCTAGATGTTTCTCA -> AACTCTAGATGTTTCTCAT
TAACTGACCGGAGGAACAC -> AACTGACCGGAGGAACACA
TAACTTCACACGCAAGACC -> AACTTCACACGCAAGACCA
TAAGAAACCAGAACCGCAC -> AAGAAACCAGAACCGCACG
TAAGGCGATCCCGCCGTCA -> AAGGCGATCCCGCCGTCAG
TAAGGCTTGACGCATTTGC -> AAGGCTTGACGCATTTGCG
TAATAAAAGTAGCAGAGAG -> AATAAAAGTAGCAGAGAGT
TAATCACTTCATTTCGCTT -> AATCACTTCATTTCGCTTT
TAATCCTCTATGACTCAGA -> AATCCTCTATGACTCAGAA
TAATCCTTAATAAAAGTAG -> AATCCTTAATAAAAGTAGC
TAATCCTTCCCGCATCTCA -> AATCCTTCCCGCATCTCAG
TAATTATCGCTTTACTGAA -> AATTATCGCTTTACTGAAA
TAATTGGTGAGACGCTATT -> AATTGGTGAGACGCTATTT
TACAACCGCTGGCAAGGTT -> ACAACCGCTGGCAAGGTTT
TACAACGTCTAACTCTAGA -> ACAACGTCTAACTCTAGAT
TACACCCCTCTTTGGATTC -> ACACCCCTCTTTGGATTCT
TACAGAAAATGACTATGAC -> ACAGAAAATGACTATGACG
TACAGGACGTGGTCATCGG -> ACAGGACGTGGTCATCGGA
TACAGTGAGTTTTCGTGAC -> ACAGTGAGTTTTCGTGACA
TACAGTTATGCGATCCACC -> ACAGTTATGCGATCCACCT
TACCCTCGGCCTGTCTAGA -> ACCCTCGGCCTGTCTAGAG
TACCGCGGTTCCATGATAA -> ACCGCGGTTCCATGATAAC
TACCGCTCGACAAAGAGCC -> ACCGCTCGACAAAGAGCCT
TACCTATCGCGTACTATAG -> ACCTATCGCGTACTATAGC
TACCTCCGTTCCACAGGCA -> ACCTCCGTTCCACAGGCAT
TACCTTAATCCTCTATGAC -> ACCTTAATCCTCTATGACT
TACGAAATTAGCTTCTCTA -> ACGAAATTAGCTTCTCTAA
TACGCACGTCTGATGAATA -> ACGCACGTCTGATGAATAT
TACGCGATAGCTACTTCAG -> ACGCGATAGCTACTTCAGA
TACGCGCTGTGGTCGGAGG -> ACGCGCTGTGGTCGGAGGC
TACGCTACGCGATAGCTAC -> ACGCTACGCGATAGCTACT
TACGGCAGACTTTACAACG -> ACGGCAGACTTTACAACGT
TACGGGTATATTAGACTCT -> ACGGGTATATTAGACTCTA
TACGGGTTCCATGCGTTTC -> ACGGGTTCCATGCGTTTCT
TACTATAGCTGTGCACACA -> ACTATAGCTGTGCACACAT
TACTATATTCTATGCAATA -> ACTATATTCTATGCAATAG
TACTCACTATATCCTGCTA -> ACTCACTATATCCTGCTAA
TACTCCGCGTATTAGAAGT -> ACTCCGCGTATTAGAAGTG
TACTGAAAATGACTATGAC -> ACTGAAAATGACTATGACG
TACTTAACAATGGAAGGGG -> ACTTAACAATGGAAGGGGC
TACTTACTCCGCGTATTAG -> ACTTACTCCGCGTATTAGA
TACTTCAGAGTAGACTTAT -> ACTTCAGAGTAGACTTATC
TAGAAACCGGCCGTGCGGG -> AGAAACCGGCCGTGCGGGG
TAGAAGTGTATCTGGCGGA -> AGAAGTGTATCTGGCGGAT
TAGACTCTATCCCTTTAAT -> AGACTCTATCCCTTTAATC
TAGACTGTTCTGCCACTTG -> AGACTGTTCTGCCACTTGT
TAGACTTATCCTGATCTAA -> AGACTTATCCTGATCTAAG
TAGAGCCAATGCTTGAAGG -> AGAGCCAATGCTTGAAGGC
TAGAGCGCGTCGTAAAACC -> AGAGCGCGTCGTAAAACCT
TAGAGGAAATGCCGAGCCC -> AGAGGAAATGCCGAGCCCT
TAGATAGCAGAGATTGGCT -> AGATAGCAGAGATTGGCTT
TAGATCTCGACTCTCAGAT -> AGATCTCGACTCTCAGATG
TAGATGTTTCTCATAGAGC -> AGATGTTTCTCATAGAGCC
TAGCAGAGAGTGTTGTATG -> AGCAGAGAGTGTTGTATGG
TAGCAGAGATTGGCTTCAA -> AGCAGAGATTGGCTTCAAC
TAGCCTTGTTAGGAAGAAT -> AGCCTTGTTAGGAAGAATC
TAGCGCAAGGGTACGCTAC -> AGCGCAAGGGTACGCTACG
TAGCTACTTCAGAGTAGAC -> AGCTACTTCAGAGTAGACT
TAGCTGTGCACACATCTGA -> AGCTGTGCACACATCTGAG
TAGCTTCTCTAAACCCTGG -> AGCTTCTCTAAACCCTGGA
TAGGAAGAATCATATTGCC -> AGGAAGAATCATATTGCCC
TAGGACGTGGTCATCGGAC -> AGGACGTGGTCATCGGACA,AGGACGTGGTCATCGGACA
TAGGCAATGCCGACCCAGC -> AGGCAATGCCGACCCAGCT
TAGGGCGGGGGTTGGGCAT -> AGGGCGGGGGTTGGGCATG
TAGGGTTTGCTGATGGAAG -> AGGGTTTGCTGATGGAAGA
TAGGTATGCGTGTACAGTT -> AGGTATGCGTGTACAGTTA
TAGGTCATGGAAAATGTAG -> AGGTCATGGAAAATGTAGC
TAGTATGGAGATGGTATAC -> AGTATGGAGATGGTATACT
TAGTCGCGCAAGTGGACCA -> AGTCGCGCAAGTGGACCAA
TATAACCCTGCAATTCAAA -> ATAACCCTGCAATTCAAAT
TATACCTTAATCCTCTATG -> ATACCTTAATCCTCTATGA
TATACGGGTTCCATGCGTT -> ATACGGGTTCCATGCGTTT
TATACTATATTCTATGCAA -> ATACTATATTCTATGCAAT
TATAGCTGTGCACACATCT -> ATAGCTGTGCACACATCTG
TATATCCTGCTAATCCTTA -> ATATCCTGCTAATCCTTAA
TATATTAGACTCTATCCCT -> ATATTAGACTCTATCCCTT
TATATTCTATGCAATAGGC -> ATATTCTATGCAATAGGCA
TATCACTACAGAAAATGAC -> ATCACTACAGAAAATGACT
TATCAGTGGCAACCGTCAT -> ATCAGTGGCAACCGTCATA
TATCCCTTTAATCCTTCCC -> ATCCCTTTAATCCTTCCCG
TATCCTGATCTAAGGCTTG -> ATCCTGATCTAAGGCTTGA
TATCCTGCTAATCCTTAAT -> ATCCTGCTAATCCTTAATA
TATCGCGTACTATAGCTGT -> ATCGCGTACTATAGCTGTG
TATCGCTTTACTGAAAATG -> ATCGCTTTACTGAAAATGA
TATCTCAACGTAGGTCATG -> ATCTCAACGTAGGTCATGG
TATCTGCTTTGGTTGCCAG -> ATCTGCTTTGGTTGCCAGG
TATCTGGCAAGCCCGTCGA -> ATCTGGCAAGCCCGTCGAT
TATCTGGCGGATACTTAAC -> ATCTGGCGGATACTTAACA
TATGACGGCAATTCCCAAC -> ATGACGGCAATTCCCAACG
TATGACGGCCGCGTTGGGA -> ATGACGGCCGCGTTGGGAT
TATGACGGCGAGTCGTGTA -> ATGACGGCGAGTCGTGTAC
TATGACGGCTGGCGAGACG -> ATGACGGCTGGCGAGACGT
TATGACTCAGAATTTAAGA -> ATGACTCAGAATTTAAGAA
TATGATCTTGAGTGTGGTG -> ATGATCTTGAGTGTGGTGT
TATGCAATAGGCAATGCCG -> ATGCAATAGGCAATGCCGA
TATGCGATCCACCTTGACG -> ATGCGATCCACCTTGACGG
TATGCGTGTACAGTTATGC -> ATGCGTGTACAGTTATGCG
TATGGACACTCTCTCTTGA -> ATGGACACTCTCTCTTGAA
TATGGAGATGGTATACTAT -> ATGGAGATGGTATACTATA
TATGGTAGTATGGAGATGG -> ATGGTAGTATGGAGATGGT
TATTAGAAGTGTATCTGGC -> ATTAGAAGTGTATCTGGCG
TATTAGACTCTATCCCTTT -> ATTAGACTCTATCCCTTTA
TATTCATTTCAGACACTAT -> ATTCATTTCAGACACTATA
TATTCTATGCAATAGGCAA -> ATTCTATGCAATAGGCAAT
TATTGAAAGCTGATGAAGG -> ATTGAAAGCTGATGAAGGT
TATTGCCACGAAGACTAAC -> ATTGCCACGAAGACTAACT
TATTGCCCGGTTACACCCC -> ATTGCCCGGTTACACCCCT
TATTTCCAATACCTCCGTT -> ATTTCCAATACCTCCGTTC
TATTTGCTGCGACTGCGCC -> ATTTGCTGCGACTGCGCCA
TCAAATGCCCGCGTTCTCA -> CAAATGCCCGCGTTCTCAA
TCAACCCTGCATGACGGAA -> CAACCCTGCATGACGGAAA
TCAACGTAGGTCATGGAAA -> CAACGTAGGTCATGGAAAA
TCAACTCATACGCACGTCT -> CAACTCATACGCACGTCTG
TCAAGTCCCGACCCGTGCC -> CAAGTCCCGACCCGTGCCG
TCAAGTGGAGGACCCTACG -> CAAGTGGAGGACCCTACGC
TCAATTAGGGCGGGGGTTG -> CAATTAGGGCGGGGGTTGG
TCAATTTACTCACTATATC -> CAATTTACTCACTATATCC
TCACACGCAAGACCAAGAA -> CACACGCAAGACCAAGAAA
TCACGCAACCGCCCGGCAC -> CACGCAACCGCCCGGCACT
TCACTACAGAAAATGACTA -> CACTACAGAAAATGACTAT
TCACTACCGCGGTTCCATG -> CACTACCGCGGTTCCATGA
TCACTATATCCTGCTAATC -> CACTATATCCTGCTAATCC
TCACTCGGATCACTACCGC -> CACTCGGATCACTACCGCG
TCACTTCATTTCGCTTTGA -> CACTTCATTTCGCTTTGAC
TCAGAATTTAAGAAACCAG -> CAGAATTTAAGAAACCAGA
TCAGACACTATACGGGTTC -> CAGACACTATACGGGTTCC
TCAGAGTAGACTTATCCTG -> CAGAGTAGACTTATCCTGA
TCAGATGCCATCTGGACGT -> CAGATGCCATCTGGACGTG
TCAGCAGAGGATGGGTCCG -> CAGCAGAGGATGGGTCCGA
TCAGCCAACCTAACCATCT -> CAGCCAACCTAACCATCTA
TCAGCGCAAGAGGGTATTC -> CAGCGCAAGAGGGTATTCA
TCAGTGGCAACCGTCATAG -> CAGTGGCAACCGTCATAGA
TCATACGCACGTCTGATGA -> CATACGCACGTCTGATGAA
TCATAGAGCCAATGCTTGA -> CATAGAGCCAATGCTTGAA
TCATAGATCTCGACTCTCA -> CATAGATCTCGACTCTCAG
TCATATTGCCCGGTTACAC -> CATATTGCCCGGTTACACC
TCATCGGACAACCAAACAC -> CATCGGACAACCAAACACG
TCATCGGACACCAGTACCG -> CATCGGACACCAGTACCGC
TCATCGGACAGGCTATCTC -> CATCGGACAGGCTATCTCA
TCATCGGACAGTGCGCTCT -> CATCGGACAGTGCGCTCTG
TCATCTTGGCTTGTAAAGA -> CATCTTGGCTTGTAAAGAG
TCATGGAAAATGTAGCCTT -> CATGGAAAATGTAGCCTTG
TCATTTCAGACACTATACG -> CATTTCAGACACTATACGG
TCATTTCGCTTTGACAGTG -> CATTTCGCTTTGACAGTGG
TCCAAATCATCTTGGCTTG -> CCAAATCATCTTGGCTTGT
TCCAATACCTCCGTTCCAC -> CCAATACCTCCGTTCCACA
TCCACAGGCATTTGTCTCG -> CCACAGGCATTTGTCTCGG
TCCACCTTGACGGTAAGGC -> CCACCTTGACGGTAAGGCG
TCCATGATAACGCAAGTGT -> CCATGATAACGCAAGTGTG
TCCATGCGTTTCTGAGGCG -> CCATGCGTTTCTGAGGCGA
TCCCAACGAGGACGTGGTC -> CCCAACGAGGACGTGGTCA
TCCCAAGGTACGGGTATAT -> CCCAAGGTACGGGTATATT
TCCCAGAGATGAGTTCCAA -> CCCAGAGATGAGTTCCAAA
TCCCATGCCCCCGCACGTT -> CCCATGCCCCCGCACGTTG
TCCCGACCCGTGCCGCCCT -> CCCGACCCGTGCCGCCCTC
TCCCGCATCTCAGCAGAGG -> CCCGCATCTCAGCAGAGGA
TCCCGCCGTCAGCGCAAGA -> CCCGCCGTCAGCGCAAGAG
TCCCGGCGGAAAATGACTA -> CCCGGCGGAAAATGACTAT
TCCCTTTAATCCTTCCCGC -> CCCTTTAATCCTTCCCGCA
TCCGAAAATGACTATGACG -> CCGAAAATGACTATGACGG
TCCGAACTGCCTTATTGCC -> CCGAACTGCCTTATTGCCA
TCCGCGTATTAGAAGTGTA -> CCGCGTATTAGAAGTGTAT
TCCGTTCCACAGGCATTTG -> CCGTTCCACAGGCATTTGT
TCCTCTATGACTCAGAATT -> CCTCTATGACTCAGAATTT
TCCTCTCTTTGGTGGTGCC -> CCTCTCTTTGGTGGTGCCG
TCCTGATCTAAGGCTTGAC -> CCTGATCTAAGGCTTGACG
TCCTGCTAATCCTTAATAA -> CCTGCTAATCCTTAATAAA
TCCTGGGCTAACCTCTCTA -> CCTGGGCTAACCTCTCTAC
TCCTTAATAAAAGTAGCAG -> CCTTAATAAAAGTAGCAGA
TCCTTCCCGCATCTCAGCA -> CCTTCCCGCATCTCAGCAG
TCGACAAAGAGCCTGGCAC -> CGACAAAGAGCCTGGCACC
TCGACTCTCAGATGCCATC -> CGACTCTCAGATGCCATCT
TCGACTGATTCGCAGCTTC -> CGACTGATTCGCAGCTTCC
TCGAGGCTCTTTTTTAGCG -> CGAGGCTCTTTTTTAGCGC
TCGAGGGTGCGTAAACAAT -> CGAGGGTGCGTAAACAATT
TCGATAGGGTTTGCTGATG -> CGATAGGGTTTGCTGATGG
TCGCAGCTTCCCGGCGGAA -> CGCAGCTTCCCGGCGGAAA
TCGCCAGGCTCGTGGAATG -> CGCCAGGCTCGTGGAATGT
TCGCGCAAGTGGACCAAGG -> CGCGCAAGTGGACCAAGGT
TCGCGTACTATAGCTGTGC -> CGCGTACTATAGCTGTGCA
TCGCTTTACTGAAAATGAC -> CGCTTTACTGAAAATGACT
TCGCTTTGACAGTGGGATG -> CGCTTTGACAGTGGGATGT
TCGGACAACCAAACACGCA -> CGGACAACCAAACACGCAG
TCGGACACCAGTACCGCTC -> CGGACACCAGTACCGCTCG
TCGGACAGGCTATCTCAAC -> CGGACAGGCTATCTCAACG
TCGGACAGTGCGCTCTGCG -> CGGACAGTGCGCTCTGCGG
TCGGAGGCCGCCGACACAA -> CGGAGGCCGCCGACACAAA
TCGGATCACTACCGCGGTT -> CGGATCACTACCGCGGTTC
TCGGCCTGTCTAGAGGAAA -> CGGCCTGTCTAGAGGAAAT
TCGGGTCCCAGAGATGAGT -> CGGGTCCCAGAGATGAGTT
TCGGTTAGATAGCAGAGAT -> CGGTTAGATAGCAGAGATT
TCGTAAAACCTTACAGTGA -> CGTAAAACCTTACAGTGAG
TCGTACTTACTCCGCGTAT -> CGTACTTACTCCGCGTATT
TCGTCCGAAAATGACTATG -> CGTCCGAAAATGACTATGA
TCGTGACAGATGCAAGGAC -> CGTGACAGATGCAAGGACG
TCGTGGAATGTAATTGGTG -> CGTGGAATGTAATTGGTGA
TCGTGTACAGGACGTGGTC -> CGTGTACAGGACGTGGTCA
TCTAAACCCTGGAGGTGGC -> CTAAACCCTGGAGGTGGCC
TCTAAATCTATTTGCTGCG -> CTAAATCTATTTGCTGCGA
TCTAACTCTAGATGTTTCT -> CTAACTCTAGATGTTTCTC
TCTAAGGCTTGACGCATTT -> CTAAGGCTTGACGCATTTG
TCTACGAAATTAGCTTCTC -> CTACGAAATTAGCTTCTCT
TCTAGACTGTTCTGCCACT -> CTAGACTGTTCTGCCACTT
TCTAGAGGAAATGCCGAGC -> CTAGAGGAAATGCCGAGCC
TCTAGATGTTTCTCATAGA -> CTAGATGTTTCTCATAGAG
TCTATCCCTTTAATCCTTC -> CTATCCCTTTAATCCTTCC
TCTATGACTCAGAATTTAA -> CTATGACTCAGAATTTAAG
TCTATGCAATAGGCAATGC -> CTATGCAATAGGCAATGCC
TCTATTTGCTGCGACTGCG -> CTATTTGCTGCGACTGCGC
TCTCAACGTAGGTCATGGA -> CTCAACGTAGGTCATGGAA
TCTCAAGTCCCGACCCGTG -> CTCAAGTCCCGACCCGTGC
TCTCAGATGCCATCTGGAC -> CTCAGATGCCATCTGGACG
TCTCAGCAGAGGATGGGTC -> CTCAGCAGAGGATGGGTCC
TCTCAGCCAACCTAACCAT -> CTCAGCCAACCTAACCATC
TCTCATAGAGCCAATGCTT -> CTCATAGAGCCAATGCTTG
TCTCGACTCTCAGATGCCA -> CTCGACTCTCAGATGCCAT
TCTCGGTTAGATAGCAGAG -> CTCGGTTAGATAGCAGAGA
TCTCTAAACCCTGGAGGTG -> CTCTAAACCCTGGAGGTGG
TCTCTACGAAATTAGCTTC -> CTCTACGAAATTAGCTTCT
TCTCTCTTGAACACGTCTG -> CTCTCTTGAACACGTCTGA
TCTCTTGAACACGTCTGAT -> CTCTTGAACACGTCTGATC
TCTCTTTGGTGGTGCCGTT -> CTCTTTGGTGGTGCCGTTA
TCTGAGCCAGTTTCGACTG -> CTGAGCCAGTTTCGACTGA
TCTGAGGCGAATACAACCG -> CTGAGGCGAATACAACCGC
TCTGATCAAGTGGAGGACC -> CTGATCAAGTGGAGGACCC
TCTGATGAATATCACTACA -> CTGATGAATATCACTACAG
TCTGCAAAACATCGTCCGA -> CTGCAAAACATCGTCCGAA
TCTGCCACTTGTGGTGTCA -> CTGCCACTTGTGGTGTCAA
TCTGCGGGGGATCAATTTA -> CTGCGGGGGATCAATTTAC
TCTGCTATTGAAAGCTGAT -> CTGCTATTGAAAGCTGATG
TCTGCTTTGGTTGCCAGGG -> CTGCTTTGGTTGCCAGGGA
TCTGGACGTGGTGATGAGG -> CTGGACGTGGTGATGAGGA
TCTGGCAAGCCCGTCGATA -> CTGGCAAGCCCGTCGATAG
TCTGGCGGATACTTAACAA -> CTGGCGGATACTTAACAAT
TCTTGAACACGTCTGATCA -> CTTGAACACGTCTGATCAA
TCTTGAGTGTGGTGTGTGA -> CTTGAGTGTGGTGTGTGAT
TCTTGGCTTGTAAAGAGGT -> CTTGGCTTGTAAAGAGGTG
TCTTTGGATTCTCAGCCAA -> CTTTGGATTCTCAGCCAAC
TCTTTGGTGGTGCCGTTAA -> CTTTGGTGGTGCCGTTAAC
TCTTTTTTAGCGCAAGGGT -> CTTTTTTAGCGCAAGGGTA
TGAAAATGACTATGACGGC -> GAAAATGACTATGACGGCT
TGAAAGCTGATGAAGGTAT -> GAAAGCTGATGAAGGTATG
TGAACACGTCTGATCAAGT -> GAACACGTCTGATCAAGTG
TGAAGGCGTTAACCATGGT -> GAAGGCGTTAACCATGGTG
TGAAGGTATGGTAGTATGG -> GAAGGTATGGTAGTATGGA
TGAATATCACTACAGAAAA -> GAATATCACTACAGAAAAT
TGACAGATGCAAGGACGTT -> GACAGATGCAAGGACGTTT
TGACAGTGGGATGTGTTCA -> GACAGTGGGATGTGTTCAC
TGACCGGAGGAACACACAG -> GACCGGAGGAACACACAGG
TGACGCATTTGCGTGCCAA -> GACGCATTTGCGTGCCAAG
TGACGGAAACTTCCCAAGG -> GACGGAAACTTCCCAAGGT
TGACGGCAATTCCCAACGA -> GACGGCAATTCCCAACGAG
TGACGGCCGCGTTGGGATA -> GACGGCCGCGTTGGGATAG
TGACGGCGAGTCGTGTACA -> GACGGCGAGTCGTGTACAG
TGACGGCTGGCGAGACGTA -> GACGGCTGGCGAGACGTAG
TGACGGTAAGGCGATCCCG -> GACGGTAAGGCGATCCCGC
TGACTATGACGGCAATTCC -> GACTATGACGGCAATTCCC
TGACTATGACGGCCGCGTT -> GACTATGACGGCCGCGTTG
TGACTATGACGGCGAGTCG -> GACTATGACGGCGAGTCGT
TGACTATGACGGCTGGCGA -> GACTATGACGGCTGGCGAG
TGACTCAGAATTTAAGAAA -> GACTCAGAATTTAAGAAAC
TGAGACGCTATTTCCAATA -> GAGACGCTATTTCCAATAC
TGAGCCAGTTTCGACTGAT -> GAGCCAGTTTCGACTGATT
TGAGCCTCGTACTTACTCC -> GAGCCTCGTACTTACTCCG
TGAGGATTTCCTGGGCTAA -> GAGGATTTCCTGGGCTAAC
TGAGGCCAAGGGAGTATCA -> GAGGCCAAGGGAGTATCAG
TGAGGCGAATACAACCGCT -> GAGGCGAATACAACCGCTG
TGAGTGTGGTGTGTGATGT -> GAGTGTGGTGTGTGATGTA
TGAGTTCCAAATCATCTTG -> GAGTTCCAAATCATCTTGG
TGAGTTTTCGTGACAGATG -> GAGTTTTCGTGACAGATGC
TGATAACGCAAGTGTGAGC -> GATAACGCAAGTGTGAGCC
TGATCAAGTGGAGGACCCT -> GATCAAGTGGAGGACCCTA
TGATCTAAGGCTTGACGCA -> GATCTAAGGCTTGACGCAT
TGATCTTGAGTGTGGTGTG -> GATCTTGAGTGTGGTGTGT
TGATGAAGGTATGGTAGTA -> GATGAAGGTATGGTAGTAT
TGATGAATATCACTACAGA -> GATGAATATCACTACAGAA
TGATGAGGATTTCCTGGGC -> GATGAGGATTTCCTGGGCT
TGATGGAAGAGGGTTTCCT -> GATGGAAGAGGGTTTCCTC
TGATGTACCTATCGCGTAC -> GATGTACCTATCGCGTACT
TGATTCGCAGCTTCCCGGC -> GATTCGCAGCTTCCCGGCG
TGATTTTACCCTCGGCCTG -> GATTTTACCCTCGGCCTGT
TGCAAAACATCGTCCGAAA -> GCAAAACATCGTCCGAAAA
TGCAAGGACGTTTGTCAAC -> GCAAGGACGTTTGTCAACT
TGCAATAGGCAATGCCGAC -> GCAATAGGCAATGCCGACC
TGCAATCGCCAGGCTCGTG -> GCAATCGCCAGGCTCGTGG
TGCAATTCAAATGCCCGCG -> GCAATTCAAATGCCCGCGT
TGCACACATCTGAGCCAGT -> GCACACATCTGAGCCAGTT
TGCACGTTCGAGGCTCTTT -> GCACGTTCGAGGCTCTTTT
TGCAGTGAGGCCAAGGGAG -> GCAGTGAGGCCAAGGGAGT
TGCATGACGGAAACTTCCC -> GCATGACGGAAACTTCCCA
TGCCAAGTCTGCTATTGAA -> GCCAAGTCTGCTATTGAAA
TGCCACGAAGACTAACTTC -> GCCACGAAGACTAACTTCA
TGCCACTTGTGGTGTCAAT -> GCCACTTGTGGTGTCAATT
TGCCAGGGACAAGATGCAC -> GCCAGGGACAAGATGCACG
TGCCATCTGGACGTGGTGA -> GCCATCTGGACGTGGTGAT
TGCCCCCGCACGTTGCAGT -> GCCCCCGCACGTTGCAGTG
TGCCCGCGTTCTCAAGTCC -> GCCCGCGTTCTCAAGTCCC
TGCCCGGTTACACCCCTCT -> GCCCGGTTACACCCCTCTT
TGCCGACCCAGCTTAATCA -> GCCGACCCAGCTTAATCAC
TGCCGAGCCCTTGTTATAC -> GCCGAGCCCTTGTTATACC
TGCCGCCCTCGAGGGTGCG -> GCCGCCCTCGAGGGTGCGT
TGCCGGTTAGTCGCGCAAG -> GCCGGTTAGTCGCGCAAGT
TGCCGTTAACTGACCGGAG -> GCCGTTAACTGACCGGAGG
TGCCTTATTGCCACGAAGA -> GCCTTATTGCCACGAAGAC
TGCGACTGCGCCAGCGTGT -> GCGACTGCGCCAGCGTGTG
TGCGATCCACCTTGACGGT -> GCGATCCACCTTGACGGTA
TGCGCTCTGCGGGGGATCA -> GCGCTCTGCGGGGGATCAA
TGCGGGGGATCAATTTACT -> GCGGGGGATCAATTTACTC
TGCGGGGTAGAGCGCGTCG -> GCGGGGTAGAGCGCGTCGT
TGCGTAAACAATTAATTAT -> GCGTAAACAATTAATTATC
TGCGTGCCAAGTCTGCTAT -> GCGTGCCAAGTCTGCTATT
TGCGTGTACAGTTATGCGA -> GCGTGTACAGTTATGCGAT
TGCGTTTCTGAGGCGAATA -> GCGTTTCTGAGGCGAATAC
TGCTAATCCTTAATAAAAG -> GCTAATCCTTAATAAAAGT
TGCTATTGAAAGCTGATGA -> GCTATTGAAAGCTGATGAA
TGCTGATGGAAGAGGGTTT -> GCTGATGGAAGAGGGTTTC
TGCTGCGACTGCGCCAGCG -> GCTGCGACTGCGCCAGCGT
TGCTTGAAGGCGTTAACCA -> GCTTGAAGGCGTTAACCAT
TGCTTTGGTTGCCAGGGAC -> GCTTTGGTTGCCAGGGACA
TGGAAAATGTAGCCTTGTT -> GGAAAATGTAGCCTTGTTA
TGGAAGAGGGTTTCCTCTC -> GGAAGAGGGTTTCCTCTCT
TGGAAGGGGCCGACGCACA -> GGAAGGGGCCGACGCACAC
TGGAATGTAATTGGTGAGA -> GGAATGTAATTGGTGAGAC
TGGACACTCTCTCTTGAAC -> GGACACTCTCTCTTGAACA
TGGACCAAGGTTCTAGACT -> GGACCAAGGTTCTAGACTG
TGGACGTGGTGATGAGGAT -> GGACGTGGTGATGAGGATT
TGGAGATGGTATACTATAT -> GGAGATGGTATACTATATT
TGGAGGACCCTACGCGCTG -> GGAGGACCCTACGCGCTGT
TGGAGGTGGCCAATCGGGT -> GGAGGTGGCCAATCGGGTC
TGGATTCTCAGCCAACCTA -> GGATTCTCAGCCAACCTAA
TGGCAACCGTCATAGATCT -> GGCAACCGTCATAGATCTC
TGGCAAGCCCGTCGATAGG -> GGCAAGCCCGTCGATAGGG
TGGCAAGGTTTGTTTATCT -> GGCAAGGTTTGTTTATCTG
TGGCAATAGAAACCGGCCG -> GGCAATAGAAACCGGCCGT
TGGCACCCGACCAGGGTTA -> GGCACCCGACCAGGGTTAC
TGGCCAATCGGGTCCCAGA -> GGCCAATCGGGTCCCAGAG
TGGCGAGACGTAGGACGTG -> GGCGAGACGTAGGACGTGG
TGGCGGATACTTAACAATG -> GGCGGATACTTAACAATGG
TGGCTTCAACCCTGCATGA -> GGCTTCAACCCTGCATGAC
TGGCTTGTAAAGAGGTGTA -> GGCTTGTAAAGAGGTGTAT
TGGGATAGGACGTGGTCAT -> GGGATAGGACGTGGTCATC
TGGGATGTGTTCACGCAAC -> GGGATGTGTTCACGCAACC
TGGGCATGGGGGCGCTGGT -> GGGCATGGGGGCGCTGGTA
TGGGCTAACCTCTCTACGA -> GGGCTAACCTCTCTACGAA
TGGGGGCGCTGGTATGATC -> GGGGGCGCTGGTATGATCT
TGGGTCCGAACTGCCTTAT -> GGGTCCGAACTGCCTTATT
TGGTAGTATGGAGATGGTA -> GGTAGTATGGAGATGGTAT
TGGTATACTATATTCTATG -> GGTATACTATATTCTATGC
TGGTATGATCTTGAGTGTG -> GGTATGATCTTGAGTGTGG
TGGTCATCGGACAACCAAA -> GGTCATCGGACAACCAAAC
TGGTCATCGGACACCAGTA -> GGTCATCGGACACCAGTAC
TGGTCATCGGACAGGCTAT -> GGTCATCGGACAGGCTATC
TGGTCATCGGACAGTGCGC -> GGTCATCGGACAGTGCGCT
TGGTCGGAGGCCGCCGACA -> GGTCGGAGGCCGCCGACAC
TGGTGAGACGCTATTTCCA -> GGTGAGACGCTATTTCCAA
TGGTGATGAGGATTTCCTG -> GGTGATGAGGATTTCCTGG
TGGTGCAATCGCCAGGCTC -> GGTGCAATCGCCAGGCTCG
TGGTGCCGTTAACTGACCG -> GGTGCCGTTAACTGACCGG
TGGTGGTGCCGTTAACTGA -> GGTGGTGCCGTTAACTGAC
TGGTGTCAATTAGGGCGGG -> GGTGTCAATTAGGGCGGGG
TGGTGTGTGATGTACCTAT -> GGTGTGTGATGTACCTATC
TGGTTGCCAGGGACAAGAT -> GGTTGCCAGGGACAAGATG
TGTAAAGAGGTGTATAACC -> GTAAAGAGGTGTATAACCC
TGTAATTGGTGAGACGCTA -> GTAATTGGTGAGACGCTAT
TGTACAGGACGTGGTCATC -> GTACAGGACGTGGTCATCG
TGTACAGTTATGCGATCCA -> GTACAGTTATGCGATCCAC
TGTACCTATCGCGTACTAT -> GTACCTATCGCGTACTATA
TGTAGCCTTGTTAGGAAGA -> GTAGCCTTGTTAGGAAGAA
TGTATAACCCTGCAATTCA -> GTATAACCCTGCAATTCAA
TGTATCTGGCGGATACTTA -> GTATCTGGCGGATACTTAA
TGTATGGACACTCTCTCTT -> GTATGGACACTCTCTCTTG
TGTCAACTCATACGCACGT -> GTCAACTCATACGCACGTC
TGTCAATTAGGGCGGGGGT -> GTCAATTAGGGCGGGGGTT
TGTCTAGAGGAAATGCCGA -> GTCTAGAGGAAATGCCGAG
TGTCTCGGTTAGATAGCAG -> GTCTCGGTTAGATAGCAGA
TGTGAGCCTCGTACTTACT -> GTGAGCCTCGTACTTACTC
TGTGATGTACCTATCGCGT -> GTGATGTACCTATCGCGTA
TGTGCACACATCTGAGCCA -> GTGCACACATCTGAGCCAG
TGTGGTCGGAGGCCGCCGA -> GTGGTCGGAGGCCGCCGAC
TGTGGTGTCAATTAGGGCG -> GTGGTGTCAATTAGGGCGG
TGTGGTGTGTGATGTACCT -> GTGGTGTGTGATGTACCTA
TGTGTGATGTACCTATCGC -> GTGTGATGTACCTATCGCG
TGTGTTCACGCAACCGCCC -> GTGTTCACGCAACCGCCCG
TGTTAGGAAGAATCATATT -> GTTAGGAAGAATCATATTG
TGTTATACCTTAATCCTCT -> GTTATACCTTAATCCTCTA
TGTTCACGCAACCGCCCGG -> GTTCACGCAACCGCCCGGC
TGTTCTGCCACTTGTGGTG -> GTTCTGCCACTTGTGGTGT
TGTTGTATGGACACTCTCT -> GTTGTATGGACACTCTCTC
TGTTTATCTGGCAAGCCCG -> GTTTATCTGGCAAGCCCGT
TGTTTCTCATAGAGCCAAT -> GTTTCTCATAGAGCCAATG
TTAAAGATGATTTTACCCT -> TAAAGATGATTTTACCCTC
TTAACAATGGAAGGGGCCG -> TAACAATGGAAGGGGCCGA
TTAACCATGGTGCAATCGC -> TAACCATGGTGCAATCGCC
TTAACGGGACACTTTAAAG -> TAACGGGACACTTTAAAGA
TTAACTGACCGGAGGAACA -> TAACTGACCGGAGGAACAC
TTAAGAAACCAGAACCGCA -> TAAGAAACCAGAACCGCAC
TTAATAAAAGTAGCAGAGA -> TAATAAAAGTAGCAGAGAG
TTAATCACTTCATTTCGCT -> TAATCACTTCATTTCGCTT
TTAATCCTCTATGACTCAG -> TAATCCTCTATGACTCAGA
TTAATCCTTCCCGCATCTC -> TAATCCTTCCCGCATCTCA
TTAATTATCGCTTTACTGA -> TAATTATCGCTTTACTGAA
TTACAACGTCTAACTCTAG -> TACAACGTCTAACTCTAGA
TTACACCCCTCTTTGGATT -> TACACCCCTCTTTGGATTC
TTACAGTGAGTTTTCGTGA -> TACAGTGAGTTTTCGTGAC
TTACCCTCGGCCTGTCTAG -> TACCCTCGGCCTGTCTAGA
TTACGGCAGACTTTACAAC -> TACGGCAGACTTTACAACG
TTACTCACTATATCCTGCT -> TACTCACTATATCCTGCTA
TTACTCCGCGTATTAGAAG -> TACTCCGCGTATTAGAAGT
TTACTGAAAATGACTATGA -> TACTGAAAATGACTATGAC
TTAGAAGTGTATCTGGCGG -> TAGAAGTGTATCTGGCGGA
TTAGACTCTATCCCTTTAA -> TAGACTCTATCCCTTTAAT
TTAGATAGCAGAGATTGGC -> TAGATAGCAGAGATTGGCT
TTAGCGCAAGGGTACGCTA -> TAGCGCAAGGGTACGCTAC
TTAGCTTCTCTAAACCCTG -> TAGCTTCTCTAAACCCTGG
TTAGGAAGAATCATATTGC -> TAGGAAGAATCATATTGCC
TTAGGGCGGGGGTTGGGCA -> TAGGGCGGGGGTTGGGCAT
TTAGTCGCGCAAGTGGACC -> TAGTCGCGCAAGTGGACCA
TTATACCTTAATCCTCTAT -> TATACCTTAATCCTCTATG
TTATCCTGATCTAAGGCTT -> TATCCTGATCTAAGGCTTG
TTATCGCTTTACTGAAAAT -> TATCGCTTTACTGAAAATG
TTATCTGGCAAGCCCGTCG -> TATCTGGCAAGCCCGTCGA
TTATGCGATCCACCTTGAC -> TATGCGATCCACCTTGACG
TTATTGCCACGAAGACTAA -> TATTGCCACGAAGACTAAC
TTCAAATGCCCGCGTTCTC -> TCAAATGCCCGCGTTCTCA
TTCAACCCTGCATGACGGA -> TCAACCCTGCATGACGGAA
TTCACACGCAAGACCAAGA -> TCACACGCAAGACCAAGAA
TTCACGCAACCGCCCGGCA -> TCACGCAACCGCCCGGCAC
TTCAGACACTATACGGGTT -> TCAGACACTATACGGGTTC
TTCAGAGTAGACTTATCCT -> TCAGAGTAGACTTATCCTG
TTCATTTCAGACACTATAC -> TCATTTCAGACACTATACG
TTCATTTCGCTTTGACAGT -> TCATTTCGCTTTGACAGTG
TTCCAAATCATCTTGGCTT -> TCCAAATCATCTTGGCTTG
TTCCAATACCTCCGTTCCA -> TCCAATACCTCCGTTCCAC
TTCCACAGGCATTTGTCTC -> TCCACAGGCATTTGTCTCG
TTCCATGATAACGCAAGTG -> TCCATGATAACGCAAGTGT
TTCCATGCGTTTCTGAGGC -> TCCATGCGTTTCTGAGGCG
TTCCCAACGAGGACGTGGT -> TCCCAACGAGGACGTGGTC
TTCCCAAGGTACGGGTATA -> TCCCAAGGTACGGGTATAT
TTCCCGCATCTCAGCAGAG -> TCCCGCATCTCAGCAGAGG
TTCCCGGCGGAAAATGACT -> TCCCGGCGGAAAATGACTA
TTCCTCTCTTTGGTGGTGC -> TCCTCTCTTTGGTGGTGCC
TTCCTGGGCTAACCTCTCT -> TCCTGGGCTAACCTCTCTA
TTCGACTGATTCGCAGCTT -> TCGACTGATTCGCAGCTTC
TTCGAGGCTCTTTTTTAGC -> TCGAGGCTCTTTTTTAGCG
TTCGCAGCTTCCCGGCGGA -> TCGCAGCTTCCCGGCGGAA
TTCGCTTTGACAGTGGGAT -> TCGCTTTGACAGTGGGATG
TTCGTGACAGATGCAAGGA -> TCGTGACAGATGCAAGGAC
TTCTAGACTGTTCTGCCAC -> TCTAGACTGTTCTGCCACT
TTCTATGCAATAGGCAATG -> TCTATGCAATAGGCAATGC
TTCTCAAGTCCCGACCCGT -> TCTCAAGTCCCGACCCGTG
TTCTCAGCCAACCTAACCA -> TCTCAGCCAACCTAACCAT
TTCTCATAGAGCCAATGCT -> TCTCATAGAGCCAATGCTT
TTCTCTAAACCCTGGAGGT -> TCTCTAAACCCTGGAGGTG
TTCTGAGGCGAATACAACC -> TCTGAGGCGAATACAACCG
TTCTGCCACTTGTGGTGTC -> TCTGCCACTTGTGGTGTCA
TTGAAAGCTGATGAAGGTA -> TGAAAGCTGATGAAGGTAT
TTGAACACGTCTGATCAAG -> TGAACACGTCTGATCAAGT
TTGAAGGCGTTAACCATGG -> TGAAGGCGTTAACCATGGT
TTGACAGTGGGATGTGTTC -> TGACAGTGGGATGTGTTCA
TTGACGCATTTGCGTGCCA -> TGACGCATTTGCGTGCCAA
TTGACGGTAAGGCGATCCC -> TGACGGTAAGGCGATCCCG
TTGAGTGTGGTGTGTGATG -> TGAGTGTGGTGTGTGATGT
TTGCAGTGAGGCCAAGGGA -> TGCAGTGAGGCCAAGGGAG
TTGCCACGAAGACTAACTT -> TGCCACGAAGACTAACTTC
TTGCCAGGGACAAGATGCA -> TGCCAGGGACAAGATGCAC
TTGCCCGGTTACACCCCTC -> TGCCCGGTTACACCCCTCT
TTGCGTGCCAAGTCTGCTA -> TGCGTGCCAAGTCTGCTAT
TTGCTGATGGAAGAGGGTT -> TGCTGATGGAAGAGGGTTT
TTGCTGCGACTGCGCCAGC -> TGCTGCGACTGCGCCAGCG
TTGGATTCTCAGCCAACCT -> TGGATTCTCAGCCAACCTA
TTGGCTTCAACCCTGCATG -> TGGCTTCAACCCTGCATGA
TTGGCTTGTAAAGAGGTGT -> TGGCTTGTAAAGAGGTGTA
TTGGGATAGGACGTGGTCA -> TGGGATAGGACGTGGTCAT
TTGGGCATGGGGGCGCTGG -> TGGGCATGGGGGCGCTGGT
TTGGTGAGACGCTATTTCC -> TGGTGAGACGCTATTTCCA
TTGGTGGTGCCGTTAACTG -> TGGTGGTGCCGTTAACTGA
TTGGTTGCCAGGGACAAGA -> TGGTTGCCAGGGACAAGAT
TTGTAAAGAGGTGTATAAC -> TGTAAAGAGGTGTATAACC
TTGTATGGACACTCTCTCT -> TGTATGGACACTCTCTCTT
TTGTCAACTCATACGCACG -> TGTCAACTCATACGCACGT
TTGTCTCGGTTAGATAGCA -> TGTCTCGGTTAGATAGCAG
TTGTGGTGTCAATTAGGGC -> TGTGGTGTCAATTAGGGCG
TTGTTAGGAAGAATCATAT -> TGTTAGGAAGAATCATATT
TTGTTATACCTTAATCCTC -> TGTTATACCTTAATCCTCT
TTGTTTATCTGGCAAGCCC -> TGTTTATCTGGCAAGCCCG
TTTAAAGATGATTTTACCC -> TTAAAGATGATTTTACCCT
TTTAACGGGACACTTTAAA -> TTAACGGGACACTTTAAAG
TTTAAGAAACCAGAACCGC -> TTAAGAAACCAGAACCGCA
TTTAATCCTTCCCGCATCT -> TTAATCCTTCCCGCATCTC
TTTACAACGTCTAACTCTA -> TTACAACGTCTAACTCTAG
TTTACCCTCGGCCTGTCTA -> TTACCCTCGGCCTGTCTAG
TTTACTCACTATATCCTGC -> TTACTCACTATATCCTGCT
TTTACTGAAAATGACTATG -> TTACTGAAAATGACTATGA
TTTAGCGCAAGGGTACGCT -> TTAGCGCAAGGGTACGCTA
TTTATCTGGCAAGCCCGTC -> TTATCTGGCAAGCCCGTCG
TTTCAGACACTATACGGGT -> TTCAGACACTATACGGGTT
TTTCCAATACCTCCGTTCC -> TTCCAATACCTCCGTTCCA
TTTCCTCTCTTTGGTGGTG -> TTCCTCTCTTTGGTGGTGC
TTTCCTGGGCTAACCTCTC -> TTCCTGGGCTAACCTCTCT
TTTCGACTGATTCGCAGCT -> TTCGACTGATTCGCAGCTT
TTTCGCTTTGACAGTGGGA -> TTCGCTTTGACAGTGGGAT
TTTCGTGACAGATGCAAGG -> TTCGTGACAGATGCAAGGA
TTTCTCATAGAGCCAATGC -> TTCTCATAGAGCCAATGCT
TTTCTGAGGCGAATACAAC -> TTCTGAGGCGAATACAACC
TTTGACAGTGGGATGTGTT -> TTGACAGTGGGATGTGTTC
TTTGCGTGCCAAGTCTGCT -> TTGCGTGCCAAGTCTGCTA
TTTGCTGATGGAAGAGGGT -> TTGCTGATGGAAGAGGGTT
TTTGCTGCGACTGCGCCAG -> TTGCTGCGACTGCGCCAGC
TTTGGATTCTCAGCCAACC -> TTGGATTCTCAGCCAACCT
TTTGGTGGTGCCGTTAACT -> TTGGTGGTGCCGTTAACTG
TTTGGTTGCCAGGGACAAG -> TTGGTTGCCAGGGACAAGA
TTTGTCAACTCATACGCAC -> TTGTCAACTCATACGCACG
TTTGTCTCGGTTAGATAGC -> TTGTCTCGGTTAGATAGCA
TTTGTTTATCTGGCAAGCC -> TTGTTTATCTGGCAAGCCC
TTTTACCCTCGGCCTGTCT -> TTTACCCTCGGCCTGTCTA
TTTTAGCGCAAGGGTACGC -> TTTAGCGCAAGGGTACGCT
TTTTCGTGACAGATGCAAG -> TTTCGTGACAGATGCAAGG
TTTTTAGCGCAAGGGTACG -> TTTTAGCGCAAGGGTACGC
TTTTTTAGCGCAAGGGTAC -> TTTTTAGCGCAAGGGTACG
