30 100
TAGCAATCGTCGGCATCGAACCCTCTTCTT|CCACACGATGACGATAGTTCGCGGGCATTC
AAAAAGCCTGCCATCCAGCAGCCCCTGGTT|AAATGGTCACGGATGCCGGGTTATCCTCAT
AGCCTGCCAACGCTGGTAGTACTTCGACCA|TCTCTCCACCCGGCCAGTTATTAAGAAAGA
CCTGCCAAAATAGGGGAACCTTCGCAAAGG|GCGGGTTCAAAAAGCCTGCCAGCCGAGTAT
GGACAAGAAAGGTTAAGCGGGTTCAAAAAG|GTTTGCCCATTAACACCCCGGATAGAATGC
GGGATATTTCGTCCTTGGCACCTAGATTAT|AGTGTATCAAGCATGTCGGGTCCCGTAGAA
CCCGGATAGAATGCGGCAGCGTGCGACCCA|CGCCCACACCCTTAACTACGCCCTGCAGGG
ATTCGTGGAAACCGAAAAGGTTAAGCGGGT|CTCGTCTGGGTTGTAGATAAAGGTTAAGCG
AAGCCTGCCAATAGGGACAAGAAAGGTTAA|TCCAGCAGCCCCTGGTTTGCCCATTAACAC
GCGGGTTCAAAAAGCCTGCCACCAGTGTAT|GGTTAAGCGGGTTCAAAAAGCCTGCCAATA
TTGCTTTGAAAGGTTAAGCGGGTTCAAAAA|AAAAGGTTAAGCGGGTTCAAAAAGCCTGCC
AGCGGGTTCAAAAAGCCTGCCAAAATAGGG|CGGGCCAAAGGTTAAGCGGGTTCAAAAAGC
AGCCTGCCATGTTATGGGATAAGGATAAAG|TGACAAAAGGTTAAGCGGGTTCAAAAAGCC
TAAGCGGGTTCAAAAAGCCTGCCAAAATAG|TTCGGGCCAAAGGTTAAGCGGGTTCAAAAA
GCCACAAAGGTTAAGCGGGTTCAAAAAGCC|GGGTTCAAAAAGCCTGCCAAGTACGATGAC
TTATACCTCCTGTTCTTCGTAAACCACCTA|AGAAAACATATGAGATTTTTAGCAATCGTC
TCTTCTTACACATATGAAGATGCCGTCACT|ATTCTCGGCCGCATTTAGAGACCAAAGGTT
GATAACCACTTGCCGCCCACACCCTTAACT|TGGGATAAGGATAAAGGTTAAGCGGGTTCA
CACCCTTAACTACGCCCTGCAGGGTCAAGT|AAGCGGGTTCAAAAAGCCTGCCACACTACA
GACCTCAATAGGTACAGAGGGGTGACCAAC|AAAAGCCCGCAACTTATATAACTCGAGTTC
CCACCACACGATGACGATAGTTCGCGGGCA|GCGTGCGACCCAAGTTTGACGGGCGCAAGC
TATTTCAACCGAAAGGTTAAGCGGGTTCAA|CCTCAATAGGTACAGAGGGGTGACCAACAA
GCTATCTCTGGCCGTGGAGGGCGGGTTGTA|GAAGACAGTTAGAGCCTATAGTCCCGAAAA
GTGAAGGGGACCTCAATAGGTACAGAGGGG|TCTTTGACAAAAGCCCGCAACTTATATAAC
CAAGAAGACAGTTAGAGCCTATAGTCCCGA|GAAATTCCCACACTTGCTCCACGTTCTCTA
CACACGATGACGATAGTTCGCGGGCATTCT|GCGACCCAAGTTTGACGGGCGCAAGCTTCT
GGGTTCAAAAAGCCTGCCACAAAGGTTAAG|AAAAGCCTGCCAAGCGGGTTCAAAAAGCCT
CCTGCCACCAGTGTATCAAGCATGTCGGGT|AAAAAGCCTGCCAATAGGGACAAGAAAGGT
ACCTAGATTATACCTCCTGTTCTTCGTAAA|GTCCCGTAGAAAACATATGAGATTTTTAGC
ACATATGAGATTTTTAGCAATCGTCGGCAT|CAAAAAGCCTGCCACCACACGATGACGATA
AGCCTGCCACACTACAAAAGGTTAAAAGGT|CTTCGCAAAGGTTAAGCGGGTTCAAAAAGC
ATGATAACCACTTGCCGCCCACACCCTTAA|TATGGGATAAGGATAAAGGTTAAGCGGGTT
CACTTGCCGCCCACACCCTTAACTACGCCC|AAGGATAAAGGTTAAGCGGGTTCAAAAAGC
TTATCCTCATGATAACCACTTGCCGCCCAC|TGCCATGTTATGGGATAAGGATAAAGGTTA
GGGGACCTCAATAGGTACAGAGGGGTGACC|GACAAAAGCCCGCAACTTATATAACTCGAG
TAGCGATTCGGGCCAAAGGTTAAGCGGGTT|GCTATCTCTGGCCGTGGAGGGCGGGTTGTA
AAGGTTAAGCGGGTTCAAAAAGCCTGCCAC|CAGAGGGGTGACCAACAAAGGTTAAGCGGG
TGAGTGTATTCGTGGAAACCGAAAAGGTTA|ACTATAACTCGTCTGGGTTGTAGATAAAGG
TGCCGCCCACACCCTTAACTACGCCCTGCA|ATAAAGGTTAAGCGGGTTCAAAAAGCCTGC
TAAAGGTTAAGCGGGTTCAAAAAGCCTGCC|CACTTGTAAAGGTTAAGCGGGTTCAAAAAG
CCGGGAGCCTGGAATGGCTATCTCTGGCCG|GTAGTACTTCGACCAAGAAGACAGTTAGAG
CTGCCAAAATAGGGGAACCTTCGCAAAGGT|CGGGTTCAAAAAGCCTGCCAGCCGAGTATT
ATTAACACCCCGGATAGAATGCGGCAGCGT|CCACTTGCCGCCCACACCCTTAACTACGCC
AGCAATCGTCGGCATCGAACCCTCTTCTTC|CACACGATGACGATAGTTCGCGGGCATTCT
CTTACATGGGTGTTGATTTAGTAAGTACCC|CTGCCACTGCGCCCGATAGTAACCACTAAC
TTAAGCGGGTTCAAAAAGCCTGCCACCAGT|TAAAGGTTAAGCGGGTTCAAAAAGCCTGCC
CGCGTAGCGCCCCCAACGGAACAAATGGTC|TTCAAAAAGCCTGCCACAAAGGTTAAGCGG
TACGCCCTGCAGGGTCAAGTGAGAGCTTTG|AAAAAGCCTGCCACACTACAAAAGGTTAAA
TACAAAAGGTTAAAAGGTTAAGCGGGTTCA|TAAGCGGGTTCAAAAAGCCTGCCATCCGAA
ACCCCCGAAGAATGCTCCGTAGCGATTCGG|TAACCGGGAGCCTGGAATGGCTATCTCTGG
TTTCGTCCTTGGCACCTAGATTATACCTCC|TCAAGCATGTCGGGTCCCGTAGAAAACATA
ATAGCTCAGGCACTTGAGTGTATTCGTGGA|TTTTTCCGGGAATCACTATAACTCGTCTGG
GCCCGATAGTAACCACTAACCGGGAGCCTG|AAAAAGCCTGCCAACGCTGGTAGTACTTCG
CCATCCAGCAGCCCCTGGTTTGCCCATTAA|GGATGCCGGGTTATCCTCATGATAACCACT
GCCTGCCACTGCGCCCGATAGTAACCACTA|TTAAGCGGGTTCAAAAAGCCTGCCAACGCT
AAATGGTCACGGATGCCGGGTTATCCTCAT|TTAAGCGGGTTCAAAAAGCCTGCCATGTTA
CCTGGAATGGCTATCTCTGGCCGTGGAGGG|TTCGACCAAGAAGACAGTTAGAGCCTATAG
ACAAGAAAGGTTAAGCGGGTTCAAAAAGCC|TTGCCCATTAACACCCCGGATAGAATGCGG
TGGAATGGCTATCTCTGGCCGTGGAGGGCG|CGACCAAGAAGACAGTTAGAGCCTATAGTC
TGCCACCAGTGTATCAAGCATGTCGGGTCC|AAAGCCTGCCAATAGGGACAAGAAAGGTTA
CAAGTGAGAGCTTTGCTTTGAAAGGTTAAG|CTACAAAAGGTTAAAAGGTTAAGCGGGTTC
AAGCGGGTTCAAAAAGCCTGCCAAGCGGGT|TGCCATCCGAATCTTACATGGGTGTTGATT
TGTTGATTTAGTAAGTACCCCCGAAGAATG|GCCCGATAGTAACCACTAACCGGGAGCCTG
GATTTTTAGCAATCGTCGGCATCGAACCCT|CTGCCACCACACGATGACGATAGTTCGCGG
AGCAGCCCCTGGTTTGCCCATTAACACCCC|CGGGTTATCCTCATGATAACCACTTGCCGC
ACCAAGAAGACAGTTAGAGCCTATAGTCCC|AAGAAATTCCCACACTTGCTCCACGTTCTC
GATAGTAACCACTAACCGGGAGCCTGGAAT|AGCCTGCCAACGCTGGTAGTACTTCGACCA
CTTCGCAAAGGTTAAGCGGGTTCAAAAAGC|CAGCCGAGTATTTCAACCGAAAGGTTAAGC
AGCCTGCCACCAGTGTATCAAGCATGTCGG|TCAAAAAGCCTGCCAATAGGGACAAGAAAG
CCCCGAAGAATGCTCCGTAGCGATTCGGGC|ACCGGGAGCCTGGAATGGCTATCTCTGGCC
AAGATGCCGTCACTTGTAAAGGTTAAGCGG|AGAGACCAAAGGTTAAGCGGGTTCAAAAAG
GGTTCAAAAAGCCTGCCAAGTACGATGACA|ATTTAGTAAGTACCCCCGAAGAATGCTCCG
GCGGGTTCAAAAAGCCTGCCAATAGGGACA|AAAGCCTGCCATCCAGCAGCCCCTGGTTTG
ACCACCTATGATTTTTCCGGGAATCACTAT|CAATCGTCGGCATCGAACCCTCTTCTTCTT
GGGTTCAAAAAGCCTGCCAAGCGGGTTCAA|ATCCGAATCTTACATGGGTGTTGATTTAGT
CTAGATTATACCTCCTGTTCTTCGTAAACC|CCCGTAGAAAACATATGAGATTTTTAGCAA
ACTTGTAAAGGTTAAGCGGGTTCAAAAAGC|GTTAAGCGGGTTCAAAAAGCCTGCCATCCA
AAGCGGGTTCAAAAAGCCTGCCAATAGGGA|AAAAAGCCTGCCATCCAGCAGCCCCTGGTT
AGCTTCTGACATGTGGTCTTCGCGTAGCGC|GCTTTGAAAGGTTAAGCGGGTTCAAAAAGC
CCTCTTCTTCTTACACATATGAAGATGCCG|CGGGCATTCTCGGCCGCATTTAGAGACCAA
CATTAACACCCCGGATAGAATGCGGCAGCG|ACCACTTGCCGCCCACACCCTTAACTACGC
GGTAGTACTTCGACCAAGAAGACAGTTAGA|CAGTTATTAAGAAAGAAATTCCCACACTTG
TCCTTGGCACCTAGATTATACCTCCTGTTC|CATGTCGGGTCCCGTAGAAAACATATGAGA
CAGGCACTTGAGTGTATTCGTGGAAACCGA|CGGGAATCACTATAACTCGTCTGGGTTGTA
GGGACCTCAATAGGTACAGAGGGGTGACCA|ACAAAAGCCCGCAACTTATATAACTCGAGT
GCTGGTAGTACTTCGACCAAGAAGACAGTT|GGCCAGTTATTAAGAAAGAAATTCCCACAC
GGTCACGGATGCCGGGTTATCCTCATGATA|GCGGGTTCAAAAAGCCTGCCATGTTATGGG
TTCAAAAAGCCTGCCAATCGAGGGATATTT|GGGTTCAAAAAGCCTGCCACCAGTGTATCA
GTGTATCAAGCATGTCGGGTCCCGTAGAAA|CCAATAGGGACAAGAAAGGTTAAGCGGGTT
ATCTTACATGGGTGTTGATTTAGTAAGTAC|GCCTGCCACTGCGCCCGATAGTAACCACTA
CCAACAAAGGTTAAGCGGGTTCAAAAAGCC|AGTTCTGACCTAAGCACTGATCTTCCTCTC
ACGGAACAAATGGTCACGGATGCCGGGTTA|ACAAAGGTTAAGCGGGTTCAAAAAGCCTGC
TATAACTCGTCTGGGTTGTAGATAAAGGTT|CTTACACATATGAAGATGCCGTCACTTGTA
CCGTAGAAAACATATGAGATTTTTAGCAAT|AAGCGGGTTCAAAAAGCCTGCCACCACACG
AGCCTGCCATCCGAATCTTACATGGGTGTT|AGCGGGTTCAAAAAGCCTGCCACTGCGCCC
GCGGGTTCAAAAAGCCTGCCATGTTATGGG|TGCCAAGTACGATGACAAAAGGTTAAGCGG
CGTCCTTGGCACCTAGATTATACCTCCTGT|AGCATGTCGGGTCCCGTAGAAAACATATGA
AGGTTAAGCGGGTTCAAAAAGCCTGCCAGC|GAGGGCGGGTTGTACTTGTTGTGTGTGAAG
CCAAGCGGGTTCAAAAAGCCTGCCAAGTAC|GGTGTTGATTTAGTAAGTACCCCCGAAGAA
GAAGATGCCGTCACTTGTAAAGGTTAAGCG|TAGAGACCAAAGGTTAAGCGGGTTCAAAAA
CGCCCTGCAGGGTCAAGTGAGAGCTTTGCT|AAAGCCTGCCACACTACAAAAGGTTAAAAG
AAGCGGGTTCAAAAAGCCTGCCATCCAGCA|CCAACGGAACAAATGGTCACGGATGCCGGG
GCTCCGTAGCGATTCGGGCCAAAGGTTAAG|GGAATGGCTATCTCTGGCCGTGGAGGGCGG
ACAAATGGTCACGGATGCCGGGTTATCCTC|GGTTAAGCGGGTTCAAAAAGCCTGCCATGT
GCGATTCGGGCCAAAGGTTAAGCGGGTTCA|TATCTCTGGCCGTGGAGGGCGGGTTGTACT
TTAAGCGGGTTCAAAAAGCCTGCCATGTTA|AGCCTGCCAAGTACGATGACAAAAGGTTAA
TGCCCATTAACACCCCGGATAGAATGCGGC|GATAACCACTTGCCGCCCACACCCTTAACT
GACAAAAGGTTAAGCGGGTTCAAAAAGCCT|TCCGTAGCGATTCGGGCCAAAGGTTAAGCG
AAGCGGGTTCAAAAAGCCTGCCACACTACA|CAAAATAGGGGAACCTTCGCAAAGGTTAAG
TAGAGACCAAAGGTTAAGCGGGTTCAAAAA|CTTCGCGTAGCGCCCCCAACGGAACAAATG
AGGGACAAGAAAGGTTAAGCGGGTTCAAAA|TGGTTTGCCCATTAACACCCCGGATAGAAT
ATGTCGGGTCCCGTAGAAAACATATGAGAT|AAGAAAGGTTAAGCGGGTTCAAAAAGCCTG
ATTTCGTCCTTGGCACCTAGATTATACCTC|ATCAAGCATGTCGGGTCCCGTAGAAAACAT
AGCGATTCGGGCCAAAGGTTAAGCGGGTTC|CTATCTCTGGCCGTGGAGGGCGGGTTGTAC
CGAGTATTTCAACCGAAAGGTTAAGCGGGT|GGGACCTCAATAGGTACAGAGGGGTGACCA
TGCCAATAGGGACAAGAAAGGTTAAGCGGG|CAGCCCCTGGTTTGCCCATTAACACCCCGG
TCAAAAAGCCTGCCAACGCTGGTAGTACTT|TCTTCCTCTCTCCACCCGGCCAGTTATTAA
GAAACCGAAAAGGTTAAGCGGGTTCAAAAA|GGGTTGTAGATAAAGGTTAAGCGGGTTCAA
ATGACAAAAGGTTAAGCGGGTTCAAAAAGC|GCTCCGTAGCGATTCGGGCCAAAGGTTAAG
GTAGAAAACATATGAGATTTTTAGCAATCG|GCGGGTTCAAAAAGCCTGCCACCACACGAT
AAAAGCCTGCCAGCCGAGTATTTCAACCGA|TGTTGTGTGTGAAGGGGACCTCAATAGGTA
CCAGCCGAGTATTTCAACCGAAAGGTTAAG|TGAAGGGGACCTCAATAGGTACAGAGGGGT
TGCCACACTACAAAAGGTTAAAAGGTTAAG|GCAAAGGTTAAGCGGGTTCAAAAAGCCTGC
GTGGAGGGCGGGTTGTACTTGTTGTGTGTG|GCCTATAGTCCCGAAAAAACGTCAGGATCT
GTTAAGCGGGTTCAAAAAGCCTGCCATGTT|AAGCCTGCCAAGTACGATGACAAAAGGTTA
TTTTAGCAATCGTCGGCATCGAACCCTCTT|CCACCACACGATGACGATAGTTCGCGGGCA
GTTCAAAAAGCCTGCCACCAGTGTATCAAG|AAGCGGGTTCAAAAAGCCTGCCAATAGGGA
TTTTTCCGGGAATCACTATAACTCGTCTGG|ATCGAACCCTCTTCTTCTTACACATATGAA
GGTTCAAAAAGCCTGCCAGCCGAGTATTTC|TGTACTTGTTGTGTGTGAAGGGGACCTCAA
GGTTTGCCCATTAACACCCCGGATAGAATG|TCATGATAACCACTTGCCGCCCACACCCTT
AATAGGTACAGAGGGGTGACCAACAAAGGT|CCGCAACTTATATAACTCGAGTTCTGACCT
GTGTCTTCCCCTCGTATAGCTCAGGCACTT|GTAAACCACCTATGATTTTTCCGGGAATCA
GTCTTCGCGTAGCGCCCCCAACGGAACAAA|GCGGGTTCAAAAAGCCTGCCACAAAGGTTA
AACCGAAAGGTTAAGCGGGTTCAAAAAGCC|TAGGTACAGAGGGGTGACCAACAAAGGTTA
ATGACGATAGTTCGCGGGCATTCTCGGCCG|CAAGTTTGACGGGCGCAAGCTTCTGACATG
ATTTCAACCGAAAGGTTAAGCGGGTTCAAA|CTCAATAGGTACAGAGGGGTGACCAACAAA
AAGCCTGCCATCCAGCAGCCCCTGGTTTGC|TGGTCACGGATGCCGGGTTATCCTCATGAT
TGAGATTTTTAGCAATCGTCGGCATCGAAC|AGCCTGCCACCACACGATGACGATAGTTCG
TTCAAAAAGCCTGCCATGTTATGGGATAAG|AGTACGATGACAAAAGGTTAAGCGGGTTCA
TTGCCCATTAACACCCCGGATAGAATGCGG|TGATAACCACTTGCCGCCCACACCCTTAAC
GATAGTTCGCGGGCATTCTCGGCCGCATTT|TTGACGGGCGCAAGCTTCTGACATGTGGTC
TAGTTCGCGGGCATTCTCGGCCGCATTTAG|GACGGGCGCAAGCTTCTGACATGTGGTCTT
CCGGGTTATCCTCATGATAACCACTTGCCG|AAGCCTGCCATGTTATGGGATAAGGATAAA
TAAGCGGGTTCAAAAAGCCTGCCAACGCTG|AAGCACTGATCTTCCTCTCTCCACCCGGCC
CAAGTACGATGACAAAAGGTTAAGCGGGTT|CGAAGAATGCTCCGTAGCGATTCGGGCCAA
GCACTTGAGTGTATTCGTGGAAACCGAAAA|GAATCACTATAACTCGTCTGGGTTGTAGAT
GTATTCGTGGAAACCGAAAAGGTTAAGCGG|AACTCGTCTGGGTTGTAGATAAAGGTTAAG
TCTGGGTTGTAGATAAAGGTTAAGCGGGTT|ATGAAGATGCCGTCACTTGTAAAGGTTAAG
GTTCAAAAAGCCTGCCAGCCGAGTATTTCA|GTACTTGTTGTGTGTGAAGGGGACCTCAAT
TGTAAAGGTTAAGCGGGTTCAAAAAGCCTG|AAGCGGGTTCAAAAAGCCTGCCATCCAGCA
GGATGCCGGGTTATCCTCATGATAACCACT|TCAAAAAGCCTGCCATGTTATGGGATAAGG
CTACGCCCTGCAGGGTCAAGTGAGAGCTTT|CAAAAAGCCTGCCACACTACAAAAGGTTAA
CATATGAAGATGCCGTCACTTGTAAAGGTT|GCATTTAGAGACCAAAGGTTAAGCGGGTTC
AAAAAGCCTGCCAAGCGGGTTCAAAAAGCC|ATCTTACATGGGTGTTGATTTAGTAAGTAC
TCCCCTCGTATAGCTCAGGCACTTGAGTGT|CACCTATGATTTTTCCGGGAATCACTATAA
AGTTAGAGCCTATAGTCCCGAAAAAACGTC|ACACTTGCTCCACGTTCTCTAGATTCTTTT
ATGCGGCAGCGTGCGACCCAAGTTTGACGG|CTTAACTACGCCCTGCAGGGTCAAGTGAGA
TGACCAACAAAGGTTAAGCGGGTTCAAAAA|TCGAGTTCTGACCTAAGCACTGATCTTCCT
GCAATCGTCGGCATCGAACCCTCTTCTTCT|ACACGATGACGATAGTTCGCGGGCATTCTC
TTCAAAAAGCCTGCCACCAGTGTATCAAGC|AGCGGGTTCAAAAAGCCTGCCAATAGGGAC
CTATCTCTGGCCGTGGAGGGCGGGTTGTAC|AAGACAGTTAGAGCCTATAGTCCCGAAAAA
GTTAAGCGGGTTCAAAAAGCCTGCCATCCG|TTTCAACCGAAAGGTTAAGCGGGTTCAAAA
GCCGTCACTTGTAAAGGTTAAGCGGGTTCA|CCAAAGGTTAAGCGGGTTCAAAAAGCCTGC
GTCCTTGGCACCTAGATTATACCTCCTGTT|GCATGTCGGGTCCCGTAGAAAACATATGAG
CCTGCCAAGTACGATGACAAAAGGTTAAGC|ACCCCCGAAGAATGCTCCGTAGCGATTCGG
ATGGGATAAGGATAAAGGTTAAGCGGGTTC|AGCGGGTTCAAAAAGCCTGCCAAAATAGGG
AAAGCCTGCCACCAGTGTATCAAGCATGTC|GTTCAAAAAGCCTGCCAATAGGGACAAGAA
GGGGAACCTTCGCAAAGGTTAAGCGGGTTC|AGCCTGCCAGCCGAGTATTTCAACCGAAAG
GACCAAGAAGACAGTTAGAGCCTATAGTCC|AAAGAAATTCCCACACTTGCTCCACGTTCT
GCCCCCAACGGAACAAATGGTCACGGATGC|GCCTGCCACAAAGGTTAAGCGGGTTCAAAA
GGTTCAAAAAGCCTGCCAAAATAGGGGAAC|CCAAAGGTTAAGCGGGTTCAAAAAGCCTGC
CCTGCCATCCGAATCTTACATGGGTGTTGA|CGGGTTCAAAAAGCCTGCCACTGCGCCCGA
TTACATGGGTGTTGATTTAGTAAGTACCCC|TGCCACTGCGCCCGATAGTAACCACTAACC
GTTAAGCGGGTTCAAAAAGCCTGCCAAGCG|GCCTGCCATCCGAATCTTACATGGGTGTTG
AAAAAGCCTGCCAAAATAGGGGAACCTTCG|GGTTAAGCGGGTTCAAAAAGCCTGCCAGCC
ATAGTTCGCGGGCATTCTCGGCCGCATTTA|TGACGGGCGCAAGCTTCTGACATGTGGTCT
AACCGAAAAGGTTAAGCGGGTTCAAAAAGC|GTTGTAGATAAAGGTTAAGCGGGTTCAAAA
AAAAGCCTGCCAATCGAGGGATATTTCGTC|TCAAAAAGCCTGCCACCAGTGTATCAAGCA
AGCGGGTTCAAAAAGCCTGCCACCAGTGTA|AGGTTAAGCGGGTTCAAAAAGCCTGCCAAT
TCAAAAAGCCTGCCACAAAGGTTAAGCGGG|GCCTGCCAAGCGGGTTCAAAAAGCCTGCCA
GCGGGTTCAAAAAGCCTGCCACACTACAAA|AAATAGGGGAACCTTCGCAAAGGTTAAGCG
CTGCCATCCAGCAGCCCCTGGTTTGCCCAT|CACGGATGCCGGGTTATCCTCATGATAACC
ACTATAACTCGTCTGGGTTGTAGATAAAGG|TTCTTACACATATGAAGATGCCGTCACTTG
TAAAGGTTAAGCGGGTTCAAAAAGCCTGCC|AAGCCTGCCAAAATAGGGGAACCTTCGCAA
GGTTAAGCGGGTTCAAAAAGCCTGCCAATA|GTTCAAAAAGCCTGCCATCCAGCAGCCCCT
TGTTCTTCGTAAACCACCTATGATTTTTCC|TGAGATTTTTAGCAATCGTCGGCATCGAAC
CCTGCCAAGCGGGTTCAAAAAGCCTGCCAA|CATGGGTGTTGATTTAGTAAGTACCCCCGA
TGCTCCGTAGCGATTCGGGCCAAAGGTTAA|TGGAATGGCTATCTCTGGCCGTGGAGGGCG
TGTATCAAGCATGTCGGGTCCCGTAGAAAA|CAATAGGGACAAGAAAGGTTAAGCGGGTTC
TGCCATCCAGCAGCCCCTGGTTTGCCCATT|ACGGATGCCGGGTTATCCTCATGATAACCA
CCGTGGAGGGCGGGTTGTACTTGTTGTGTG|GAGCCTATAGTCCCGAAAAAACGTCAGGAT
TTCAAAAAGCCTGCCAATAGGGACAAGAAA|CTGCCATCCAGCAGCCCCTGGTTTGCCCAT
CTCGTCTGGGTTGTAGATAAAGGTTAAGCG|ACATATGAAGATGCCGTCACTTGTAAAGGT
TAGTAACCACTAACCGGGAGCCTGGAATGG|CCTGCCAACGCTGGTAGTACTTCGACCAAG
GGGTTGTACTTGTTGTGTGTGAAGGGGACC|CCCGAAAAAACGTCAGGATCTTTGACAAAA
GCACCTAGATTATACCTCCTGTTCTTCGTA|GGGTCCCGTAGAAAACATATGAGATTTTTA
TTGGCACCTAGATTATACCTCCTGTTCTTC|GTCGGGTCCCGTAGAAAACATATGAGATTT
GAAAAAACGTCAGGATCTTTGACAAAAGCC|TAGATTCTTTTAACACAGATGTCCTCAATG
CCGCATTTAGAGACCAAAGGTTAAGCGGGT|ATGTGGTCTTCGCGTAGCGCCCCCAACGGA
TATGAAGATGCCGTCACTTGTAAAGGTTAA|ATTTAGAGACCAAAGGTTAAGCGGGTTCAA
CGGCATCGAACCCTCTTCTTCTTACACATA|ACGATAGTTCGCGGGCATTCTCGGCCGCAT
CAACAAAGGTTAAGCGGGTTCAAAAAGCCT|GTTCTGACCTAAGCACTGATCTTCCTCTCT
GCCCATTAACACCCCGGATAGAATGCGGCA|ATAACCACTTGCCGCCCACACCCTTAACTA
CAAAAAGCCTGCCAAGCGGGTTCAAAAAGC|AATCTTACATGGGTGTTGATTTAGTAAGTA
ACTCGTCTGGGTTGTAGATAAAGGTTAAGC|CACATATGAAGATGCCGTCACTTGTAAAGG
GATAAAGGTTAAGCGGGTTCAAAAAGCCTG|AAAAGCCTGCCAAAATAGGGGAACCTTCGC
CCTGCCATCCAGCAGCCCCTGGTTTGCCCA|TCACGGATGCCGGGTTATCCTCATGATAAC
TAACCACTTGCCGCCCACACCCTTAACTAC|GGATAAGGATAAAGGTTAAGCGGGTTCAAA
GACAAGAAAGGTTAAGCGGGTTCAAAAAGC|TTTGCCCATTAACACCCCGGATAGAATGCG
GCCTGCCAATCGAGGGATATTTCGTCCTTG|AAAGCCTGCCACCAGTGTATCAAGCATGTC
CAAGCATGTCGGGTCCCGTAGAAAACATAT|GGGACAAGAAAGGTTAAGCGGGTTCAAAAA
AGAATGCGGCAGCGTGCGACCCAAGTTTGA|ACCCTTAACTACGCCCTGCAGGGTCAAGTG
AAGCCTGCCAACGCTGGTAGTACTTCGACC|CTCTCTCCACCCGGCCAGTTATTAAGAAAG
GGGTGTTGATTTAGTAAGTACCCCCGAAGA|TGCGCCCGATAGTAACCACTAACCGGGAGC
TCGTCTGGGTTGTAGATAAAGGTTAAGCGG|CATATGAAGATGCCGTCACTTGTAAAGGTT
ACTACAAAAGGTTAAAAGGTTAAGCGGGTT|GTTAAGCGGGTTCAAAAAGCCTGCCATCCG
GCCTGCCACAAAGGTTAAGCGGGTTCAAAA|AAGCGGGTTCAAAAAGCCTGCCAAGTACGA
TTAAGCGGGTTCAAAAAGCCTGCCAATAGG|TCAAAAAGCCTGCCATCCAGCAGCCCCTGG
GGTTCAAAAAGCCTGCCACCACACGATGAC|GGATAGAATGCGGCAGCGTGCGACCCAAGT
AAAGGTTAAGCGGGTTCAAAAAGCCTGCCA|CAAAAAGCCTGCCAAGTACGATGACAAAAG
AAAGCCTGCCAAGCGGGTTCAAAAAGCCTG|CTTACATGGGTGTTGATTTAGTAAGTACCC
TATGAGATTTTTAGCAATCGTCGGCATCGA|AAAGCCTGCCACCACACGATGACGATAGTT
GCGCAAGCTTCTGACATGTGGTCTTCGCGT|GCTTTGCTTTGAAAGGTTAAGCGGGTTCAA
GCGGGTTCAAAAAGCCTGCCATCCAGCAGC|AACGGAACAAATGGTCACGGATGCCGGGTT
TTGAAAGGTTAAGCGGGTTCAAAAAGCCTG|GTTAAGCGGGTTCAAAAAGCCTGCCAAGCG
CAGGGTCAAGTGAGAGCTTTGCTTTGAAAG|GCCACACTACAAAAGGTTAAAAGGTTAAGC
GCGGGTTCAAAAAGCCTGCCACTGCGCCCG|TGACCAACAAAGGTTAAGCGGGTTCAAAAA
TCGGCATCGAACCCTCTTCTTCTTACACAT|GACGATAGTTCGCGGGCATTCTCGGCCGCA
GCCCTGCAGGGTCAAGTGAGAGCTTTGCTT|AAGCCTGCCACACTACAAAAGGTTAAAAGG
AGGTTAAAAGGTTAAGCGGGTTCAAAAAGC|GGTTCAAAAAGCCTGCCATCCGAATCTTAC
AAGCTTCTGACATGTGGTCTTCGCGTAGCG|TGCTTTGAAAGGTTAAGCGGGTTCAAAAAG
CGTCGGCATCGAACCCTCTTCTTCTTACAC|ATGACGATAGTTCGCGGGCATTCTCGGCCG
AACACCCCGGATAGAATGCGGCAGCGTGCG|CTTGCCGCCCACACCCTTAACTACGCCCTG
GTCCCGTAGAAAACATATGAGATTTTTAGC|GTTAAGCGGGTTCAAAAAGCCTGCCACCAC
CAGCGTGCGACCCAAGTTTGACGGGCGCAA|TACGCCCTGCAGGGTCAAGTGAGAGCTTTG
TCGTCGGCATCGAACCCTCTTCTTCTTACA|GATGACGATAGTTCGCGGGCATTCTCGGCC
TGGAAACCGAAAAGGTTAAGCGGGTTCAAA|CTGGGTTGTAGATAAAGGTTAAGCGGGTTC
ATCGTCGGCATCGAACCCTCTTCTTCTTAC|CGATGACGATAGTTCGCGGGCATTCTCGGC
CTGCCAAGTACGATGACAAAAGGTTAAGCG|CCCCCGAAGAATGCTCCGTAGCGATTCGGG
ATCCTCATGATAACCACTTGCCGCCCACAC|CCATGTTATGGGATAAGGATAAAGGTTAAG
GGGTTCAAAAAGCCTGCCAACGCTGGTAGT|CTGATCTTCCTCTCTCCACCCGGCCAGTTA
TAAGCGGGTTCAAAAAGCCTGCCACTGCGC|GGGTGACCAACAAAGGTTAAGCGGGTTCAA
TAAGCGGGTTCAAAAAGCCTGCCATCCAGC|CCCAACGGAACAAATGGTCACGGATGCCGG
TTAAAAGGTTAAGCGGGTTCAAAAAGCCTG|TCAAAAAGCCTGCCATCCGAATCTTACATG
GCGGGTTCAAAAAGCCTGCCACAAAGGTTA|CAAAAAGCCTGCCAAGCGGGTTCAAAAAGC
GACCAAAGGTTAAGCGGGTTCAAAAAGCCT|GCGTAGCGCCCCCAACGGAACAAATGGTCA
AATGGCTATCTCTGGCCGTGGAGGGCGGGT|CCAAGAAGACAGTTAGAGCCTATAGTCCCG
AGCGGGTTCAAAAAGCCTGCCAAGTACGAT|GTTGATTTAGTAAGTACCCCCGAAGAATGC
GTAGCGATTCGGGCCAAAGGTTAAGCGGGT|GGCTATCTCTGGCCGTGGAGGGCGGGTTGT
TGACAAAAGGTTAAGCGGGTTCAAAAAGCC|CTCCGTAGCGATTCGGGCCAAAGGTTAAGC
TCCTCATGATAACCACTTGCCGCCCACACC|CATGTTATGGGATAAGGATAAAGGTTAAGC
TGGTCTTCGCGTAGCGCCCCCAACGGAACA|AAGCGGGTTCAAAAAGCCTGCCACAAAGGT
CTGGAATGGCTATCTCTGGCCGTGGAGGGC|TCGACCAAGAAGACAGTTAGAGCCTATAGT
CCTCAATAGGTACAGAGGGGTGACCAACAA|AAGCCCGCAACTTATATAACTCGAGTTCTG
GGTGTCTTCCCCTCGTATAGCTCAGGCACT|CGTAAACCACCTATGATTTTTCCGGGAATC
ACCTTCGCAAAGGTTAAGCGGGTTCAAAAA|GCCAGCCGAGTATTTCAACCGAAAGGTTAA
TAGTACTTCGACCAAGAAGACAGTTAGAGC|GTTATTAAGAAAGAAATTCCCACACTTGCT
AAAGGTTAAGCGGGTTCAAAAAGCCTGCCA|TGGAGGGCGGGTTGTACTTGTTGTGTGTGA
CCACTAACCGGGAGCCTGGAATGGCTATCT|AACGCTGGTAGTACTTCGACCAAGAAGACA
AGCCTGCCAATAGGGACAAGAAAGGTTAAG|CCAGCAGCCCCTGGTTTGCCCATTAACACC
CAAGCTTCTGACATGTGGTCTTCGCGTAGC|TTGCTTTGAAAGGTTAAGCGGGTTCAAAAA
GTGGAAACCGAAAAGGTTAAGCGGGTTCAA|TCTGGGTTGTAGATAAAGGTTAAGCGGGTT
AAAGGTTAAAAGGTTAAGCGGGTTCAAAAA|CGGGTTCAAAAAGCCTGCCATCCGAATCTT
CTGACATGTGGTCTTCGCGTAGCGCCCCCA|GAAAGGTTAAGCGGGTTCAAAAAGCCTGCC
ACTTGTTGTGTGTGAAGGGGACCTCAATAG|AAACGTCAGGATCTTTGACAAAAGCCCGCA
CCAAGTTTGACGGGCGCAAGCTTCTGACAT|GGGTCAAGTGAGAGCTTTGCTTTGAAAGGT
AGCGGGTTCAAAAAGCCTGCCATCCAGCAG|CAACGGAACAAATGGTCACGGATGCCGGGT
GATGCCGTCACTTGTAAAGGTTAAGCGGGT|AGACCAAAGGTTAAGCGGGTTCAAAAAGCC
TAAGCGGGTTCAAAAAGCCTGCCAAGCGGG|CTGCCATCCGAATCTTACATGGGTGTTGAT
TAAGCGGGTTCAAAAAGCCTGCCAGCCGAG|GCGGGTTGTACTTGTTGTGTGTGAAGGGGA
GGTTAAAAGGTTAAGCGGGTTCAAAAAGCC|GTTCAAAAAGCCTGCCATCCGAATCTTACA
TGGTCACGGATGCCGGGTTATCCTCATGAT|AGCGGGTTCAAAAAGCCTGCCATGTTATGG
TTGCCGCCCACACCCTTAACTACGCCCTGC|GATAAAGGTTAAGCGGGTTCAAAAAGCCTG
TTGTACTTGTTGTGTGTGAAGGGGACCTCA|GAAAAAACGTCAGGATCTTTGACAAAAGCC
AAAAGCCTGCCACCAGTGTATCAAGCATGT|GGTTCAAAAAGCCTGCCAATAGGGACAAGA
GTAACCACTAACCGGGAGCCTGGAATGGCT|TGCCAACGCTGGTAGTACTTCGACCAAGAA
TGGCTATCTCTGGCCGTGGAGGGCGGGTTG|AAGAAGACAGTTAGAGCCTATAGTCCCGAA
GAAAGGTTAAGCGGGTTCAAAAAGCCTGCC|TACAGAGGGGTGACCAACAAAGGTTAAGCG
TTCAAAAAGCCTGCCAAGTACGATGACAAA|TTAGTAAGTACCCCCGAAGAATGCTCCGTA
GCCTGGAATGGCTATCTCTGGCCGTGGAGG|CTTCGACCAAGAAGACAGTTAGAGCCTATA
AGCGGGTTCAAAAAGCCTGCCATCCGAATC|AACCGAAAGGTTAAGCGGGTTCAAAAAGCC
TAGAAAACATATGAGATTTTTAGCAATCGT|CGGGTTCAAAAAGCCTGCCACCACACGATG
AAAAGCCTGCCATCCGAATCTTACATGGGT|TTAAGCGGGTTCAAAAAGCCTGCCACTGCG
CGTAGCGCCCCCAACGGAACAAATGGTCAC|CAAAAAGCCTGCCACAAAGGTTAAGCGGGT
ACCACTTGCCGCCCACACCCTTAACTACGC|ATAAGGATAAAGGTTAAGCGGGTTCAAAAA
CATGTGGTCTTCGCGTAGCGCCCCCAACGG|GGTTAAGCGGGTTCAAAAAGCCTGCCACAA
CACCTAGATTATACCTCCTGTTCTTCGTAA|GGTCCCGTAGAAAACATATGAGATTTTTAG
CTGCCAGCCGAGTATTTCAACCGAAAGGTT|GTGTGAAGGGGACCTCAATAGGTACAGAGG
CCCCTGGTTTGCCCATTAACACCCCGGATA|TATCCTCATGATAACCACTTGCCGCCCACA
TTAAGCGGGTTCAAAAAGCCTGCCATCCGA|TTCAACCGAAAGGTTAAGCGGGTTCAAAAA
GTTCAAAAAGCCTGCCATGTTATGGGATAA|AAGTACGATGACAAAAGGTTAAGCGGGTTC
ACTTGAGTGTATTCGTGGAAACCGAAAAGG|ATCACTATAACTCGTCTGGGTTGTAGATAA
ATTATACCTCCTGTTCTTCGTAAACCACCT|TAGAAAACATATGAGATTTTTAGCAATCGT
CAATAGGTACAGAGGGGTGACCAACAAAGG|CCCGCAACTTATATAACTCGAGTTCTGACC
GGAGCCTGGAATGGCTATCTCTGGCCGTGG|GTACTTCGACCAAGAAGACAGTTAGAGCCT
GTTATCCTCATGATAACCACTTGCCGCCCA|CTGCCATGTTATGGGATAAGGATAAAGGTT
GCCACCAGTGTATCAAGCATGTCGGGTCCC|AAGCCTGCCAATAGGGACAAGAAAGGTTAA
GTACAGAGGGGTGACCAACAAAGGTTAAGC|ACTTATATAACTCGAGTTCTGACCTAAGCA
AAGGTTAAGCGGGTTCAAAAAGCCTGCCAT|GCGCCCCCAACGGAACAAATGGTCACGGAT
TTTAGTAAGTACCCCCGAAGAATGCTCCGT|TAGTAACCACTAACCGGGAGCCTGGAATGG
CCACTGCGCCCGATAGTAACCACTAACCGG|CGGGTTCAAAAAGCCTGCCAACGCTGGTAG
AAGGATAAAGGTTAAGCGGGTTCAAAAAGC|TCAAAAAGCCTGCCAAAATAGGGGAACCTT
TCAAAAAGCCTGCCATCCAGCAGCCCCTGG|ACAAATGGTCACGGATGCCGGGTTATCCTC
CGGCAGCGTGCGACCCAAGTTTGACGGGCG|AACTACGCCCTGCAGGGTCAAGTGAGAGCT
TATTCGTGGAAACCGAAAAGGTTAAGCGGG|ACTCGTCTGGGTTGTAGATAAAGGTTAAGC
ACATGGGTGTTGATTTAGTAAGTACCCCCG|CCACTGCGCCCGATAGTAACCACTAACCGG
GGTTAAGCGGGTTCAAAAAGCCTGCCAACG|CCTAAGCACTGATCTTCCTCTCTCCACCCG
CACCTATGATTTTTCCGGGAATCACTATAA|ATCGTCGGCATCGAACCCTCTTCTTCTTAC
AGATTTTTAGCAATCGTCGGCATCGAACCC|CCTGCCACCACACGATGACGATAGTTCGCG
CTTTGCTTTGAAAGGTTAAGCGGGTTCAAA|TTAAAAGGTTAAGCGGGTTCAAAAAGCCTG
CCTTAACTACGCCCTGCAGGGTCAAGTGAG|CGGGTTCAAAAAGCCTGCCACACTACAAAA
GTTGATTTAGTAAGTACCCCCGAAGAATGC|CCCGATAGTAACCACTAACCGGGAGCCTGG
AATCGAGGGATATTTCGTCCTTGGCACCTA|GCCACCAGTGTATCAAGCATGTCGGGTCCC
ACAGTTAGAGCCTATAGTCCCGAAAAAACG|CCACACTTGCTCCACGTTCTCTAGATTCTT
GCCCCTGGTTTGCCCATTAACACCCCGGAT|TTATCCTCATGATAACCACTTGCCGCCCAC
AATAGGGGAACCTTCGCAAAGGTTAAGCGG|AAAAAGCCTGCCAGCCGAGTATTTCAACCG
TAAGCGGGTTCAAAAAGCCTGCCATCCGAA|TCAACCGAAAGGTTAAGCGGGTTCAAAAAG
AAGCCTGCCATCCGAATCTTACATGGGTGT|AAGCGGGTTCAAAAAGCCTGCCACTGCGCC
TCAAAAAGCCTGCCAAGTACGATGACAAAA|TAGTAAGTACCCCCGAAGAATGCTCCGTAG
AAGGTTAAGCGGGTTCAAAAAGCCTGCCAT|AAAAAGCCTGCCAAGTACGATGACAAAAGG
TGCCAACGCTGGTAGTACTTCGACCAAGAA|TCCACCCGGCCAGTTATTAAGAAAGAAATT
TAAGGATAAAGGTTAAGCGGGTTCAAAAAG|TTCAAAAAGCCTGCCAAAATAGGGGAACCT
CTTGAGTGTATTCGTGGAAACCGAAAAGGT|TCACTATAACTCGTCTGGGTTGTAGATAAA
GGTCTTCGCGTAGCGCCCCCAACGGAACAA|AGCGGGTTCAAAAAGCCTGCCACAAAGGTT
CGGGCATTCTCGGCCGCATTTAGAGACCAA|GCAAGCTTCTGACATGTGGTCTTCGCGTAG
CGGGTTCAAAAAGCCTGCCAATAGGGACAA|AAGCCTGCCATCCAGCAGCCCCTGGTTTGC
TTAAGCGGGTTCAAAAAGCCTGCCACCACA|ACACCCCGGATAGAATGCGGCAGCGTGCGA
CCCCCAACGGAACAAATGGTCACGGATGCC|CCTGCCACAAAGGTTAAGCGGGTTCAAAAA
AAGGTTAAGCGGGTTCAAAAAGCCTGCCAC|GCCTGCCAAAATAGGGGAACCTTCGCAAAG
GTGTGTGAAGGGGACCTCAATAGGTACAGA|AGGATCTTTGACAAAAGCCCGCAACTTATA
GGTGTTGATTTAGTAAGTACCCCCGAAGAA|GCGCCCGATAGTAACCACTAACCGGGAGCC
GGGTTCAAAAAGCCTGCCACCACACGATGA|CGGATAGAATGCGGCAGCGTGCGACCCAAG
CAAAAAGCCTGCCAACGCTGGTAGTACTTC|CTTCCTCTCTCCACCCGGCCAGTTATTAAG
CACTATAACTCGTCTGGGTTGTAGATAAAG|CTTCTTACACATATGAAGATGCCGTCACTT
CGCCCACACCCTTAACTACGCCCTGCAGGG|AAGGTTAAGCGGGTTCAAAAAGCCTGCCAC
CAATCGAGGGATATTTCGTCCTTGGCACCT|TGCCACCAGTGTATCAAGCATGTCGGGTCC
ACGCTGGTAGTACTTCGACCAAGAAGACAG|CCGGCCAGTTATTAAGAAAGAAATTCCCAC
TCTTCTTCTTACACATATGAAGATGCCGTC|GGCATTCTCGGCCGCATTTAGAGACCAAAG
TTCGTAAACCACCTATGATTTTTCCGGGAA|TTTTTAGCAATCGTCGGCATCGAACCCTCT
GCCTGCCACCACACGATGACGATAGTTCGC|CGGCAGCGTGCGACCCAAGTTTGACGGGCG
ATAAAGGTTAAGCGGGTTCAAAAAGCCTGC|TCACTTGTAAAGGTTAAGCGGGTTCAAAAA
CGATGACAAAAGGTTAAGCGGGTTCAAAAA|ATGCTCCGTAGCGATTCGGGCCAAAGGTTA
GCGTGCGACCCAAGTTTGACGGGCGCAAGC|CGCCCTGCAGGGTCAAGTGAGAGCTTTGCT
CAAAAAGCCTGCCAAAATAGGGGAACCTTC|AGGTTAAGCGGGTTCAAAAAGCCTGCCAGC
GTTAAGCGGGTTCAAAAAGCCTGCCACTGC|AGGGGTGACCAACAAAGGTTAAGCGGGTTC
CACCCCGGATAGAATGCGGCAGCGTGCGAC|TGCCGCCCACACCCTTAACTACGCCCTGCA
AGGTTAAGCGGGTTCAAAAAGCCTGCCAAT|TAAAGGTTAAGCGGGTTCAAAAAGCCTGCC
CCTGCCAATCGAGGGATATTTCGTCCTTGG|AAGCCTGCCACCAGTGTATCAAGCATGTCG
ATAAAGGTTAAGCGGGTTCAAAAAGCCTGC|AAAGCCTGCCAAAATAGGGGAACCTTCGCA
CCCGTAGAAAACATATGAGATTTTTAGCAA|TAAGCGGGTTCAAAAAGCCTGCCACCACAC
AAACCACCTATGATTTTTCCGGGAATCACT|AGCAATCGTCGGCATCGAACCCTCTTCTTC
TAAAGGTTAAGCGGGTTCAAAAAGCCTGCC|GCGGGTTCAAAAAGCCTGCCATCCAGCAGC
CCAATCGAGGGATATTTCGTCCTTGGCACC|CTGCCACCAGTGTATCAAGCATGTCGGGTC
TTCGACCAAGAAGACAGTTAGAGCCTATAG|AAGAAAGAAATTCCCACACTTGCTCCACGT
AAGGTTAAGCGGGTTCAAAAAGCCTGCCAC|CTTGTAAAGGTTAAGCGGGTTCAAAAAGCC
ATACCTCCTGTTCTTCGTAAACCACCTATG|AAAACATATGAGATTTTTAGCAATCGTCGG
GTTAAGCGGGTTCAAAAAGCCTGCCAATAG|TTCAAAAAGCCTGCCATCCAGCAGCCCCTG
GGTTCAAAAAGCCTGCCACACTACAAAAGG|TAGGGGAACCTTCGCAAAGGTTAAGCGGGT
GGTTCAAAAAGCCTGCCAATCGAGGGATAT|GCGGGTTCAAAAAGCCTGCCACCAGTGTAT
TTAAGCGGGTTCAAAAAGCCTGCCAAGCGG|CCTGCCATCCGAATCTTACATGGGTGTTGA
GCCTGCCAAGCGGGTTCAAAAAGCCTGCCA|ACATGGGTGTTGATTTAGTAAGTACCCCCG
AGGTTAAGCGGGTTCAAAAAGCCTGCCAAA|GCGATTCGGGCCAAAGGTTAAGCGGGTTCA
GGTTAAGCGGGTTCAAAAAGCCTGCCACCA|TAACACCCCGGATAGAATGCGGCAGCGTGC
GCGGGTTCAAAAAGCCTGCCAAGCGGGTTC|CCATCCGAATCTTACATGGGTGTTGATTTA
CATTCTCGGCCGCATTTAGAGACCAAAGGT|GCTTCTGACATGTGGTCTTCGCGTAGCGCC
ACGGATGCCGGGTTATCCTCATGATAACCA|GTTCAAAAAGCCTGCCATGTTATGGGATAA
TTCTGACATGTGGTCTTCGCGTAGCGCCCC|TTGAAAGGTTAAGCGGGTTCAAAAAGCCTG
GTATTTCAACCGAAAGGTTAAGCGGGTTCA|ACCTCAATAGGTACAGAGGGGTGACCAACA
GCCATCCAGCAGCCCCTGGTTTGCCCATTA|CGGATGCCGGGTTATCCTCATGATAACCAC
TAAAAGGTTAAGCGGGTTCAAAAAGCCTGC|CAAAAAGCCTGCCATCCGAATCTTACATGG
CTGCCAATCGAGGGATATTTCGTCCTTGGC|AGCCTGCCACCAGTGTATCAAGCATGTCGG
GGCATCGAACCCTCTTCTTCTTACACATAT|CGATAGTTCGCGGGCATTCTCGGCCGCATT
ATGCCGTCACTTGTAAAGGTTAAGCGGGTT|GACCAAAGGTTAAGCGGGTTCAAAAAGCCT
CGTCACTTGTAAAGGTTAAGCGGGTTCAAA|AAAGGTTAAGCGGGTTCAAAAAGCCTGCCA
TGCCACCACACGATGACGATAGTTCGCGGG|CAGCGTGCGACCCAAGTTTGACGGGCGCAA
CAAAAGGTTAAGCGGGTTCAAAAAGCCTGC|CGTAGCGATTCGGGCCAAAGGTTAAGCGGG
GCCGGGTTATCCTCATGATAACCACTTGCC|AAAGCCTGCCATGTTATGGGATAAGGATAA
GCCACCACACGATGACGATAGTTCGCGGGC|AGCGTGCGACCCAAGTTTGACGGGCGCAAG
TTACACATATGAAGATGCCGTCACTTGTAA|CGGCCGCATTTAGAGACCAAAGGTTAAGCG
AGGGGAACCTTCGCAAAGGTTAAGCGGGTT|AAGCCTGCCAGCCGAGTATTTCAACCGAAA
GTAAAGGTTAAGCGGGTTCAAAAAGCCTGC|AGCGGGTTCAAAAAGCCTGCCATCCAGCAG
TCGCAAAGGTTAAGCGGGTTCAAAAAGCCT|GCCGAGTATTTCAACCGAAAGGTTAAGCGG
GGGTCCCGTAGAAAACATATGAGATTTTTA|AGGTTAAGCGGGTTCAAAAAGCCTGCCACC
AGATGCCGTCACTTGTAAAGGTTAAGCGGG|GAGACCAAAGGTTAAGCGGGTTCAAAAAGC
TCCGAATCTTACATGGGTGTTGATTTAGTA|AAAAAGCCTGCCACTGCGCCCGATAGTAAC
ATCTCTGGCCGTGGAGGGCGGGTTGTACTT|GACAGTTAGAGCCTATAGTCCCGAAAAAAC
TCAATAGGTACAGAGGGGTGACCAACAAAG|GCCCGCAACTTATATAACTCGAGTTCTGAC
CTTCGTAAACCACCTATGATTTTTCCGGGA|ATTTTTAGCAATCGTCGGCATCGAACCCTC
AAGGTTAAGCGGGTTCAAAAAGCCTGCCAA|GACCTAAGCACTGATCTTCCTCTCTCCACC
ACCTATGATTTTTCCGGGAATCACTATAAC|TCGTCGGCATCGAACCCTCTTCTTCTTACA
AATCGTCGGCATCGAACCCTCTTCTTCTTA|ACGATGACGATAGTTCGCGGGCATTCTCGG
CATATGAGATTTTTAGCAATCGTCGGCATC|AAAAAGCCTGCCACCACACGATGACGATAG
AGGGGTGACCAACAAAGGTTAAGCGGGTTC|ATAACTCGAGTTCTGACCTAAGCACTGATC
TCCGGGAATCACTATAACTCGTCTGGGTTG|AACCCTCTTCTTCTTACACATATGAAGATG
TGCCGGGTTATCCTCATGATAACCACTTGC|AAAAGCCTGCCATGTTATGGGATAAGGATA
CGACCCAAGTTTGACGGGCGCAAGCTTCTG|TGCAGGGTCAAGTGAGAGCTTTGCTTTGAA
GGTCAAGTGAGAGCTTTGCTTTGAAAGGTT|ACACTACAAAAGGTTAAAAGGTTAAGCGGG
GAATGGCTATCTCTGGCCGTGGAGGGCGGG|ACCAAGAAGACAGTTAGAGCCTATAGTCCC
GCATGTCGGGTCCCGTAGAAAACATATGAG|ACAAGAAAGGTTAAGCGGGTTCAAAAAGCC
CAATAGGGACAAGAAAGGTTAAGCGGGTTC|CCCCTGGTTTGCCCATTAACACCCCGGATA
TCAAAAAGCCTGCCACCAGTGTATCAAGCA|GCGGGTTCAAAAAGCCTGCCAATAGGGACA
AGGTTAAGCGGGTTCAAAAAGCCTGCCACA|GCGGGTTCAAAAAGCCTGCCAAGCGGGTTC
GTGAGAGCTTTGCTTTGAAAGGTTAAGCGG|CAAAAGGTTAAAAGGTTAAGCGGGTTCAAA
AAAAGCCTGCCAAGCGGGTTCAAAAAGCCT|TCTTACATGGGTGTTGATTTAGTAAGTACC
GTCCCGAAAAAACGTCAGGATCTTTGACAA|TTCTCTAGATTCTTTTAACACAGATGTCCT
CGATAGTAACCACTAACCGGGAGCCTGGAA|AAGCCTGCCAACGCTGGTAGTACTTCGACC
ACCAAAGGTTAAGCGGGTTCAAAAAGCCTG|CGTAGCGCCCCCAACGGAACAAATGGTCAC
CGCGGGCATTCTCGGCCGCATTTAGAGACC|GCGCAAGCTTCTGACATGTGGTCTTCGCGT
TCAAAAAGCCTGCCAATCGAGGGATATTTC|GGTTCAAAAAGCCTGCCACCAGTGTATCAA
GGAAACCGAAAAGGTTAAGCGGGTTCAAAA|TGGGTTGTAGATAAAGGTTAAGCGGGTTCA
GGTTCAAAAAGCCTGCCAACGCTGGTAGTA|TGATCTTCCTCTCTCCACCCGGCCAGTTAT
TAAGCGGGTTCAAAAAGCCTGCCAATAGGG|CAAAAAGCCTGCCATCCAGCAGCCCCTGGT
GCCTGCCAACGCTGGTAGTACTTCGACCAA|CTCTCCACCCGGCCAGTTATTAAGAAAGAA
AGTACGATGACAAAAGGTTAAGCGGGTTCA|AAGAATGCTCCGTAGCGATTCGGGCCAAAG
GTTCAAAAAGCCTGCCAATAGGGACAAGAA|CCTGCCATCCAGCAGCCCCTGGTTTGCCCA
ACCCAAGTTTGACGGGCGCAAGCTTCTGAC|CAGGGTCAAGTGAGAGCTTTGCTTTGAAAG
GGGTTATCCTCATGATAACCACTTGCCGCC|GCCTGCCATGTTATGGGATAAGGATAAAGG
GGTTAAGCGGGTTCAAAAAGCCTGCCATCC|GCCCCCAACGGAACAAATGGTCACGGATGC
AAAAGCCTGCCAACGCTGGTAGTACTTCGA|TCCTCTCTCCACCCGGCCAGTTATTAAGAA
CTTGTTGTGTGTGAAGGGGACCTCAATAGG|AACGTCAGGATCTTTGACAAAAGCCCGCAA
GGTTCAAAAAGCCTGCCACAAAGGTTAAGC|AAAGCCTGCCAAGCGGGTTCAAAAAGCCTG
AAAAAGCCTGCCACCAGTGTATCAAGCATG|GGGTTCAAAAAGCCTGCCAATAGGGACAAG
CGGATGCCGGGTTATCCTCATGATAACCAC|TTCAAAAAGCCTGCCATGTTATGGGATAAG
ACATATGAAGATGCCGTCACTTGTAAAGGT|CGCATTTAGAGACCAAAGGTTAAGCGGGTT
CCTCGTATAGCTCAGGCACTTGAGTGTATT|CTATGATTTTTCCGGGAATCACTATAACTC
CGATTCGGGCCAAAGGTTAAGCGGGTTCAA|ATCTCTGGCCGTGGAGGGCGGGTTGTACTT
GGATAAAGGTTAAGCGGGTTCAAAAAGCCT|AAAAAGCCTGCCAAAATAGGGGAACCTTCG
TTAAGCGGGTTCAAAAAGCCTGCCATCCAG|CCCCAACGGAACAAATGGTCACGGATGCCG
TGGGTTGTAGATAAAGGTTAAGCGGGTTCA|GAAGATGCCGTCACTTGTAAAGGTTAAGCG
GCTTCTGACATGTGGTCTTCGCGTAGCGCC|CTTTGAAAGGTTAAGCGGGTTCAAAAAGCC
ATAGTAACCACTAACCGGGAGCCTGGAATG|GCCTGCCAACGCTGGTAGTACTTCGACCAA
TCGGCCGCATTTAGAGACCAAAGGTTAAGC|TGACATGTGGTCTTCGCGTAGCGCCCCCAA
AGCGGGTTCAAAAAGCCTGCCAGCCGAGTA|GGGTTGTACTTGTTGTGTGTGAAGGGGACC
TTTTTAGCAATCGTCGGCATCGAACCCTCT|GCCACCACACGATGACGATAGTTCGCGGGC
CAAAAAGCCTGCCATGTTATGGGATAAGGA|TACGATGACAAAAGGTTAAGCGGGTTCAAA
GTCACTTGTAAAGGTTAAGCGGGTTCAAAA|AAGGTTAAGCGGGTTCAAAAAGCCTGCCAT
TCCGTAGCGATTCGGGCCAAAGGTTAAGCG|AATGGCTATCTCTGGCCGTGGAGGGCGGGT
GTCGGCATCGAACCCTCTTCTTCTTACACA|TGACGATAGTTCGCGGGCATTCTCGGCCGC
GCCTGCCACCAGTGTATCAAGCATGTCGGG|CAAAAAGCCTGCCAATAGGGACAAGAAAGG
TGGGATAAGGATAAAGGTTAAGCGGGTTCA|GCGGGTTCAAAAAGCCTGCCAAAATAGGGG
GGTTGTAGATAAAGGTTAAGCGGGTTCAAA|AGATGCCGTCACTTGTAAAGGTTAAGCGGG
AAGCCTGCCAAAATAGGGGAACCTTCGCAA|TAAGCGGGTTCAAAAAGCCTGCCAGCCGAG
CCTGCCAGCCGAGTATTTCAACCGAAAGGT|TGTGTGAAGGGGACCTCAATAGGTACAGAG
TCAAAAAGCCTGCCACACTACAAAAGGTTA|GGGAACCTTCGCAAAGGTTAAGCGGGTTCA
GTTAAGCGGGTTCAAAAAGCCTGCCAGCCG|GGGCGGGTTGTACTTGTTGTGTGTGAAGGG
AAAGGTTAAGCGGGTTCAAAAAGCCTGCCA|GATAAAGGTTAAGCGGGTTCAAAAAGCCTG
AAAAGGTTAAAAGGTTAAGCGGGTTCAAAA|GCGGGTTCAAAAAGCCTGCCATCCGAATCT
AAAAGCCTGCCAATAGGGACAAGAAAGGTT|CATCCAGCAGCCCCTGGTTTGCCCATTAAC
TGCCAAGTACGATGACAAAAGGTTAAGCGG|CCCCGAAGAATGCTCCGTAGCGATTCGGGC
GCCATCCGAATCTTACATGGGTGTTGATTT|GTTCAAAAAGCCTGCCACTGCGCCCGATAG
AACTACGCCCTGCAGGGTCAAGTGAGAGCT|TTCAAAAAGCCTGCCACACTACAAAAGGTT
GGTTCAAAAAGCCTGCCATCCGAATCTTAC|GAAAGGTTAAGCGGGTTCAAAAAGCCTGCC
CGGGAATCACTATAACTCGTCTGGGTTGTA|CCCTCTTCTTCTTACACATATGAAGATGCC
CAGTGTATCAAGCATGTCGGGTCCCGTAGA|TGCCAATAGGGACAAGAAAGGTTAAGCGGG
CGGATAGAATGCGGCAGCGTGCGACCCAAG|CCCACACCCTTAACTACGCCCTGCAGGGTC
GCCAAAGGTTAAGCGGGTTCAAAAAGCCTG|CCGTGGAGGGCGGGTTGTACTTGTTGTGTG
CGCATTTAGAGACCAAAGGTTAAGCGGGTT|TGTGGTCTTCGCGTAGCGCCCCCAACGGAA
TTCAAAAAGCCTGCCACAAAGGTTAAGCGG|AGCCTGCCAAGCGGGTTCAAAAAGCCTGCC
AGCGGGTTCAAAAAGCCTGCCACACTACAA|AAAATAGGGGAACCTTCGCAAAGGTTAAGC
GAGAGCTTTGCTTTGAAAGGTTAAGCGGGT|AAAGGTTAAAAGGTTAAGCGGGTTCAAAAA
TTTTCCGGGAATCACTATAACTCGTCTGGG|TCGAACCCTCTTCTTCTTACACATATGAAG
AAGAAGACAGTTAGAGCCTATAGTCCCGAA|AAATTCCCACACTTGCTCCACGTTCTCTAG
CTCCGTAGCGATTCGGGCCAAAGGTTAAGC|GAATGGCTATCTCTGGCCGTGGAGGGCGGG
CTGGCCGTGGAGGGCGGGTTGTACTTGTTG|GTTAGAGCCTATAGTCCCGAAAAAACGTCA
AGCCTGCCAAGCGGGTTCAAAAAGCCTGCC|TACATGGGTGTTGATTTAGTAAGTACCCCC
GGGTTCAAAAAGCCTGCCATCCGAATCTTA|CGAAAGGTTAAGCGGGTTCAAAAAGCCTGC
GGTTAAGCGGGTTCAAAAAGCCTGCCAGCC|AGGGCGGGTTGTACTTGTTGTGTGTGAAGG
CGGGTTCAAAAAGCCTGCCAATCGAGGGAT|AAGCGGGTTCAAAAAGCCTGCCACCAGTGT
GGGTTGTAGATAAAGGTTAAGCGGGTTCAA|AAGATGCCGTCACTTGTAAAGGTTAAGCGG
GTATAGCTCAGGCACTTGAGTGTATTCGTG|GATTTTTCCGGGAATCACTATAACTCGTCT
ACAGAGGGGTGACCAACAAAGGTTAAGCGG|TTATATAACTCGAGTTCTGACCTAAGCACT
ACTACGCCCTGCAGGGTCAAGTGAGAGCTT|TCAAAAAGCCTGCCACACTACAAAAGGTTA
TGCCACTGCGCCCGATAGTAACCACTAACC|AGCGGGTTCAAAAAGCCTGCCAACGCTGGT
ACTGCGCCCGATAGTAACCACTAACCGGGA|GGTTCAAAAAGCCTGCCAACGCTGGTAGTA
CAAAGGTTAAGCGGGTTCAAAAAGCCTGCC|CTGACCTAAGCACTGATCTTCCTCTCTCCA
CGGGTTCAAAAAGCCTGCCATCCAGCAGCC|ACGGAACAAATGGTCACGGATGCCGGGTTA
CGGAACAAATGGTCACGGATGCCGGGTTAT|CAAAGGTTAAGCGGGTTCAAAAAGCCTGCC
ATATTTCGTCCTTGGCACCTAGATTATACC|GTATCAAGCATGTCGGGTCCCGTAGAAAAC
GTAAACCACCTATGATTTTTCCGGGAATCA|TTAGCAATCGTCGGCATCGAACCCTCTTCT
TCTTCGCGTAGCGCCCCCAACGGAACAAAT|CGGGTTCAAAAAGCCTGCCACAAAGGTTAA
AGCGGGTTCAAAAAGCCTGCCAATCGAGGG|TTAAGCGGGTTCAAAAAGCCTGCCACCAGT
GACGGGCGCAAGCTTCTGACATGTGGTCTT|TGAGAGCTTTGCTTTGAAAGGTTAAGCGGG
GGTTAAGCGGGTTCAAAAAGCCTGCCACTG|GAGGGGTGACCAACAAAGGTTAAGCGGGTT
CGGGTTGTACTTGTTGTGTGTGAAGGGGAC|TCCCGAAAAAACGTCAGGATCTTTGACAAA
TGATAACCACTTGCCGCCCACACCCTTAAC|ATGGGATAAGGATAAAGGTTAAGCGGGTTC
TAGGGGAACCTTCGCAAAGGTTAAGCGGGT|AAAGCCTGCCAGCCGAGTATTTCAACCGAA
GAAGACAGTTAGAGCCTATAGTCCCGAAAA|ATTCCCACACTTGCTCCACGTTCTCTAGAT
ATGGTCACGGATGCCGGGTTATCCTCATGA|AAGCGGGTTCAAAAAGCCTGCCATGTTATG
GATAAAGGTTAAGCGGGTTCAAAAAGCCTG|GTCACTTGTAAAGGTTAAGCGGGTTCAAAA
CCTGCCACAAAGGTTAAGCGGGTTCAAAAA|AGCGGGTTCAAAAAGCCTGCCAAGTACGAT
GCGGGTTCAAAAAGCCTGCCACCACACGAT|CCCGGATAGAATGCGGCAGCGTGCGACCCA
ACGCCCTGCAGGGTCAAGTGAGAGCTTTGC|AAAAGCCTGCCACACTACAAAAGGTTAAAA
GTGGTCTTCGCGTAGCGCCCCCAACGGAAC|TAAGCGGGTTCAAAAAGCCTGCCACAAAGG
TACCCCCGAAGAATGCTCCGTAGCGATTCG|CTAACCGGGAGCCTGGAATGGCTATCTCTG
TGTCGGGTCCCGTAGAAAACATATGAGATT|AGAAAGGTTAAGCGGGTTCAAAAAGCCTGC
CCTGCCATGTTATGGGATAAGGATAAAGGT|ACAAAAGGTTAAGCGGGTTCAAAAAGCCTG
CCCTCTTCTTCTTACACATATGAAGATGCC|GCGGGCATTCTCGGCCGCATTTAGAGACCA
AAAAGGTTAAGCGGGTTCAAAAAGCCTGCC|GTAGCGATTCGGGCCAAAGGTTAAGCGGGT
GACCAACAAAGGTTAAGCGGGTTCAAAAAG|CGAGTTCTGACCTAAGCACTGATCTTCCTC
TATGATTTTTCCGGGAATCACTATAACTCG|TCGGCATCGAACCCTCTTCTTCTTACACAT
ACCAGTGTATCAAGCATGTCGGGTCCCGTA|CCTGCCAATAGGGACAAGAAAGGTTAAGCG
TACAGAGGGGTGACCAACAAAGGTTAAGCG|CTTATATAACTCGAGTTCTGACCTAAGCAC
TCACGGATGCCGGGTTATCCTCATGATAAC|GGGTTCAAAAAGCCTGCCATGTTATGGGAT
CGTGGAAACCGAAAAGGTTAAGCGGGTTCA|GTCTGGGTTGTAGATAAAGGTTAAGCGGGT
GTTCAAAAAGCCTGCCACAAAGGTTAAGCG|AAGCCTGCCAAGCGGGTTCAAAAAGCCTGC
AACCTTCGCAAAGGTTAAGCGGGTTCAAAA|TGCCAGCCGAGTATTTCAACCGAAAGGTTA
AACTCGTCTGGGTTGTAGATAAAGGTTAAG|ACACATATGAAGATGCCGTCACTTGTAAAG
GTGTATTCGTGGAAACCGAAAAGGTTAAGC|ATAACTCGTCTGGGTTGTAGATAAAGGTTA
ACCACTAACCGGGAGCCTGGAATGGCTATC|CAACGCTGGTAGTACTTCGACCAAGAAGAC
CGTAGCGATTCGGGCCAAAGGTTAAGCGGG|TGGCTATCTCTGGCCGTGGAGGGCGGGTTG
CACATATGAAGATGCCGTCACTTGTAAAGG|CCGCATTTAGAGACCAAAGGTTAAGCGGGT
CTTGGCACCTAGATTATACCTCCTGTTCTT|TGTCGGGTCCCGTAGAAAACATATGAGATT
GGCACTTGAGTGTATTCGTGGAAACCGAAA|GGAATCACTATAACTCGTCTGGGTTGTAGA
ATTCTCGGCCGCATTTAGAGACCAAAGGTT|CTTCTGACATGTGGTCTTCGCGTAGCGCCC
GTTAAGCGGGTTCAAAAAGCCTGCCAATCG|AAGGTTAAGCGGGTTCAAAAAGCCTGCCAC
TATACCTCCTGTTCTTCGTAAACCACCTAT|GAAAACATATGAGATTTTTAGCAATCGTCG
AACCGGGAGCCTGGAATGGCTATCTCTGGC|TGGTAGTACTTCGACCAAGAAGACAGTTAG
TATAGTCCCGAAAAAACGTCAGGATCTTTG|CACGTTCTCTAGATTCTTTTAACACAGATG
CTGCCACCAGTGTATCAAGCATGTCGGGTC|AAAAGCCTGCCAATAGGGACAAGAAAGGTT
GAGCTTTGCTTTGAAAGGTTAAGCGGGTTC|AGGTTAAAAGGTTAAGCGGGTTCAAAAAGC
CAAAAAGCCTGCCATCCAGCAGCCCCTGGT|CAAATGGTCACGGATGCCGGGTTATCCTCA
AAGCCTGCCACACTACAAAAGGTTAAAAGG|CCTTCGCAAAGGTTAAGCGGGTTCAAAAAG
GGGTTCAAAAAGCCTGCCAGCCGAGTATTT|TTGTACTTGTTGTGTGTGAAGGGGACCTCA
CGGGTTCAAAAAGCCTGCCATCCGAATCTT|CCGAAAGGTTAAGCGGGTTCAAAAAGCCTG
GGGTTCAAAAAGCCTGCCATCCAGCAGCCC|CGGAACAAATGGTCACGGATGCCGGGTTAT
GCCAAGTACGATGACAAAAGGTTAAGCGGG|CCCGAAGAATGCTCCGTAGCGATTCGGGCC
GGGCATTCTCGGCCGCATTTAGAGACCAAA|CAAGCTTCTGACATGTGGTCTTCGCGTAGC
GGTTAAGCGGGTTCAAAAAGCCTGCCAAGC|AGCCTGCCATCCGAATCTTACATGGGTGTT
GGTTAAGCGGGTTCAAAAAGCCTGCCAATC|AAAGGTTAAGCGGGTTCAAAAAGCCTGCCA
AAGGGGACCTCAATAGGTACAGAGGGGTGA|TTGACAAAAGCCCGCAACTTATATAACTCG
AAAGCCTGCCATCCAGCAGCCCCTGGTTTG|ATGGTCACGGATGCCGGGTTATCCTCATGA
AAAAAGCCTGCCACACTACAAAAGGTTAAA|GAACCTTCGCAAAGGTTAAGCGGGTTCAAA
CGACCAAGAAGACAGTTAGAGCCTATAGTC|GAAAGAAATTCCCACACTTGCTCCACGTTC
ACTTGCCGCCCACACCCTTAACTACGCCCT|AGGATAAAGGTTAAGCGGGTTCAAAAAGCC
TTAAGCGGGTTCAAAAAGCCTGCCAAAATA|ATTCGGGCCAAAGGTTAAGCGGGTTCAAAA
TCCCGAAAAAACGTCAGGATCTTTGACAAA|TCTCTAGATTCTTTTAACACAGATGTCCTC
AAAAGCCTGCCACAAAGGTTAAGCGGGTTC|TGCCAAGCGGGTTCAAAAAGCCTGCCAAGT
TCTTCCCCTCGTATAGCTCAGGCACTTGAG|AACCACCTATGATTTTTCCGGGAATCACTA
CCTATGATTTTTCCGGGAATCACTATAACT|CGTCGGCATCGAACCCTCTTCTTCTTACAC
TCGGGTCCCGTAGAAAACATATGAGATTTT|AAAGGTTAAGCGGGTTCAAAAAGCCTGCCA
GGGAGCCTGGAATGGCTATCTCTGGCCGTG|AGTACTTCGACCAAGAAGACAGTTAGAGCC
TGTGGTCTTCGCGTAGCGCCCCCAACGGAA|TTAAGCGGGTTCAAAAAGCCTGCCACAAAG
CAAAGGTTAAGCGGGTTCAAAAAGCCTGCC|GAGTATTTCAACCGAAAGGTTAAGCGGGTT
AAGCGGGTTCAAAAAGCCTGCCACTGCGCC|GGTGACCAACAAAGGTTAAGCGGGTTCAAA
CTAACCGGGAGCCTGGAATGGCTATCTCTG|GCTGGTAGTACTTCGACCAAGAAGACAGTT
GTTAAAAGGTTAAGCGGGTTCAAAAAGCCT|TTCAAAAAGCCTGCCATCCGAATCTTACAT
AGATTATACCTCCTGTTCTTCGTAAACCAC|CGTAGAAAACATATGAGATTTTTAGCAATC
AGAGCTTTGCTTTGAAAGGTTAAGCGGGTT|AAGGTTAAAAGGTTAAGCGGGTTCAAAAAG
GCCAACGCTGGTAGTACTTCGACCAAGAAG|CCACCCGGCCAGTTATTAAGAAAGAAATTC
GTCTTCCCCTCGTATAGCTCAGGCACTTGA|AAACCACCTATGATTTTTCCGGGAATCACT
GTTCAAAAAGCCTGCCAAGTACGATGACAA|TTTAGTAAGTACCCCCGAAGAATGCTCCGT
CTGCCAAGCGGGTTCAAAAAGCCTGCCAAG|ATGGGTGTTGATTTAGTAAGTACCCCCGAA
GTTCGCGGGCATTCTCGGCCGCATTTAGAG|CGGGCGCAAGCTTCTGACATGTGGTCTTCG
GCGCCCGATAGTAACCACTAACCGGGAGCC|TCAAAAAGCCTGCCAACGCTGGTAGTACTT
CCAAAGGTTAAGCGGGTTCAAAAAGCCTGC|CGTGGAGGGCGGGTTGTACTTGTTGTGTGT
AAGCCTGCCAAGTACGATGACAAAAGGTTA|AGTACCCCCGAAGAATGCTCCGTAGCGATT
GCCGTGGAGGGCGGGTTGTACTTGTTGTGT|AGAGCCTATAGTCCCGAAAAAACGTCAGGA
AGTGTATTCGTGGAAACCGAAAAGGTTAAG|TATAACTCGTCTGGGTTGTAGATAAAGGTT
AAAGGTTAAGCGGGTTCAAAAAGCCTGCCA|AGCGCCCCCAACGGAACAAATGGTCACGGA
CCACACGATGACGATAGTTCGCGGGCATTC|TGCGACCCAAGTTTGACGGGCGCAAGCTTC
CTGGTTTGCCCATTAACACCCCGGATAGAA|CCTCATGATAACCACTTGCCGCCCACACCC
CAACCGAAAGGTTAAGCGGGTTCAAAAAGC|ATAGGTACAGAGGGGTGACCAACAAAGGTT
TACGATGACAAAAGGTTAAGCGGGTTCAAA|GAATGCTCCGTAGCGATTCGGGCCAAAGGT
TTTGCCCATTAACACCCCGGATAGAATGCG|ATGATAACCACTTGCCGCCCACACCCTTAA
CCGGATAGAATGCGGCAGCGTGCGACCCAA|GCCCACACCCTTAACTACGCCCTGCAGGGT
CAAAAAGCCTGCCACCAGTGTATCAAGCAT|CGGGTTCAAAAAGCCTGCCAATAGGGACAA
AGCCTGCCACCACACGATGACGATAGTTCG|GCGGCAGCGTGCGACCCAAGTTTGACGGGC
GAAAAGGTTAAGCGGGTTCAAAAAGCCTGC|TAGATAAAGGTTAAGCGGGTTCAAAAAGCC
CAAAAAGCCTGCCAATAGGGACAAGAAAGG|GCCATCCAGCAGCCCCTGGTTTGCCCATTA
AACAAATGGTCACGGATGCCGGGTTATCCT|AGGTTAAGCGGGTTCAAAAAGCCTGCCATG
GTTCAAAAAGCCTGCCAACGCTGGTAGTAC|GATCTTCCTCTCTCCACCCGGCCAGTTATT
AAAGCCTGCCAACGCTGGTAGTACTTCGAC|CCTCTCTCCACCCGGCCAGTTATTAAGAAA
TCAAAAAGCCTGCCAATAGGGACAAGAAAG|TGCCATCCAGCAGCCCCTGGTTTGCCCATT
GTTATGGGATAAGGATAAAGGTTAAGCGGG|TTAAGCGGGTTCAAAAAGCCTGCCAAAATA
ACCTCAATAGGTACAGAGGGGTGACCAACA|AAAGCCCGCAACTTATATAACTCGAGTTCT
AAAGGTTAAGCGGGTTCAAAAAGCCTGCCA|ACTTGTAAAGGTTAAGCGGGTTCAAAAAGC
CATCGAACCCTCTTCTTCTTACACATATGA|ATAGTTCGCGGGCATTCTCGGCCGCATTTA
CACTGCGCCCGATAGTAACCACTAACCGGG|GGGTTCAAAAAGCCTGCCAACGCTGGTAGT
TGAAGATGCCGTCACTTGTAAAGGTTAAGC|TTAGAGACCAAAGGTTAAGCGGGTTCAAAA
AAGTGAGAGCTTTGCTTTGAAAGGTTAAGC|TACAAAAGGTTAAAAGGTTAAGCGGGTTCA
GAATGCTCCGTAGCGATTCGGGCCAAAGGT|GCCTGGAATGGCTATCTCTGGCCGTGGAGG
AAAAACGTCAGGATCTTTGACAAAAGCCCG|GATTCTTTTAACACAGATGTCCTCAATGAG
TGCCAAGCGGGTTCAAAAAGCCTGCCAAGT|TGGGTGTTGATTTAGTAAGTACCCCCGAAG
AGCCTGGAATGGCTATCTCTGGCCGTGGAG|ACTTCGACCAAGAAGACAGTTAGAGCCTAT
CCAGTGTATCAAGCATGTCGGGTCCCGTAG|CTGCCAATAGGGACAAGAAAGGTTAAGCGG
TAGATAAAGGTTAAGCGGGTTCAAAAAGCC|CCGTCACTTGTAAAGGTTAAGCGGGTTCAA
GCGGGTTCAAAAAGCCTGCCAAGTACGATG|TTGATTTAGTAAGTACCCCCGAAGAATGCT
AGGGCGGGTTGTACTTGTTGTGTGTGAAGG|ATAGTCCCGAAAAAACGTCAGGATCTTTGA
TGCCAGCCGAGTATTTCAACCGAAAGGTTA|TGTGAAGGGGACCTCAATAGGTACAGAGGG
GGGTGACCAACAAAGGTTAAGCGGGTTCAA|AACTCGAGTTCTGACCTAAGCACTGATCTT
AAGCCTGCCACAAAGGTTAAGCGGGTTCAA|CCAAGCGGGTTCAAAAAGCCTGCCAAGTAC
TTAAGCGGGTTCAAAAAGCCTGCCACTGCG|GGGGTGACCAACAAAGGTTAAGCGGGTTCA
GAACCTTCGCAAAGGTTAAGCGGGTTCAAA|CTGCCAGCCGAGTATTTCAACCGAAAGGTT
TGTAGATAAAGGTTAAGCGGGTTCAAAAAG|TGCCGTCACTTGTAAAGGTTAAGCGGGTTC
ACCGAAAGGTTAAGCGGGTTCAAAAAGCCT|AGGTACAGAGGGGTGACCAACAAAGGTTAA
AGGTTAAGCGGGTTCAAAAAGCCTGCCATC|CGCCCCCAACGGAACAAATGGTCACGGATG
GCTTTGCTTTGAAAGGTTAAGCGGGTTCAA|GTTAAAAGGTTAAGCGGGTTCAAAAAGCCT
AGCCGAGTATTTCAACCGAAAGGTTAAGCG|AAGGGGACCTCAATAGGTACAGAGGGGTGA
GCATTCTCGGCCGCATTTAGAGACCAAAGG|AGCTTCTGACATGTGGTCTTCGCGTAGCGC
TTAAGCGGGTTCAAAAAGCCTGCCAACGCT|TAAGCACTGATCTTCCTCTCTCCACCCGGC
GCAAGCTTCTGACATGTGGTCTTCGCGTAG|TTTGCTTTGAAAGGTTAAGCGGGTTCAAAA
CCATTAACACCCCGGATAGAATGCGGCAGC|AACCACTTGCCGCCCACACCCTTAACTACG
CACACCCTTAACTACGCCCTGCAGGGTCAA|TTAAGCGGGTTCAAAAAGCCTGCCACACTA
ACATGTGGTCTTCGCGTAGCGCCCCCAACG|AGGTTAAGCGGGTTCAAAAAGCCTGCCACA
AAGCCTGCCACCACACGATGACGATAGTTC|TGCGGCAGCGTGCGACCCAAGTTTGACGGG
AACGGAACAAATGGTCACGGATGCCGGGTT|CACAAAGGTTAAGCGGGTTCAAAAAGCCTG
CAAAAGGTTAAAAGGTTAAGCGGGTTCAAA|AGCGGGTTCAAAAAGCCTGCCATCCGAATC
AAAAGCCTGCCACTGCGCCCGATAGTAACC|AAGGTTAAGCGGGTTCAAAAAGCCTGCCAA
GATTCGGGCCAAAGGTTAAGCGGGTTCAAA|TCTCTGGCCGTGGAGGGCGGGTTGTACTTG
CCAAAATAGGGGAACCTTCGCAAAGGTTAA|GTTCAAAAAGCCTGCCAGCCGAGTATTTCA
ACCGGGAGCCTGGAATGGCTATCTCTGGCC|GGTAGTACTTCGACCAAGAAGACAGTTAGA
TTCTCGGCCGCATTTAGAGACCAAAGGTTA|TTCTGACATGTGGTCTTCGCGTAGCGCCCC
AAAGCCTGCCATGTTATGGGATAAGGATAA|GATGACAAAAGGTTAAGCGGGTTCAAAAAG
TGCGGCAGCGTGCGACCCAAGTTTGACGGG|TTAACTACGCCCTGCAGGGTCAAGTGAGAG
AGAAAGGTTAAGCGGGTTCAAAAAGCCTGC|CCCATTAACACCCCGGATAGAATGCGGCAG
TCAAAAAGCCTGCCATCCGAATCTTACATG|AGGTTAAGCGGGTTCAAAAAGCCTGCCACT
ATAGTCCCGAAAAAACGTCAGGATCTTTGA|ACGTTCTCTAGATTCTTTTAACACAGATGT
CAAAAAGCCTGCCACCACACGATGACGATA|AGAATGCGGCAGCGTGCGACCCAAGTTTGA
AAAACGTCAGGATCTTTGACAAAAGCCCGC|ATTCTTTTAACACAGATGTCCTCAATGAGA
AAACATATGAGATTTTTAGCAATCGTCGGC|TTCAAAAAGCCTGCCACCACACGATGACGA
GGGTTCAAAAAGCCTGCCAAAATAGGGGAA|GCCAAAGGTTAAGCGGGTTCAAAAAGCCTG
CCAGCAGCCCCTGGTTTGCCCATTAACACC|GCCGGGTTATCCTCATGATAACCACTTGCC
GAATGCGGCAGCGTGCGACCCAAGTTTGAC|CCCTTAACTACGCCCTGCAGGGTCAAGTGA
AAAAAGCCTGCCACAAAGGTTAAGCGGGTT|CTGCCAAGCGGGTTCAAAAAGCCTGCCAAG
GCCGAGTATTTCAACCGAAAGGTTAAGCGG|AGGGGACCTCAATAGGTACAGAGGGGTGAC
CAAAAAGCCTGCCAAGTACGATGACAAAAG|AGTAAGTACCCCCGAAGAATGCTCCGTAGC
GGGCGGGTTGTACTTGTTGTGTGTGAAGGG|TAGTCCCGAAAAAACGTCAGGATCTTTGAC
ACGATAGTTCGCGGGCATTCTCGGCCGCAT|GTTTGACGGGCGCAAGCTTCTGACATGTGG
ACAAAGGTTAAGCGGGTTCAAAAAGCCTGC|TTCAAAAAGCCTGCCAAGTACGATGACAAA
AGAGACCAAAGGTTAAGCGGGTTCAAAAAG|TTCGCGTAGCGCCCCCAACGGAACAAATGG
ATCCAGCAGCCCCTGGTTTGCCCATTAACA|ATGCCGGGTTATCCTCATGATAACCACTTG
CCCTGGTTTGCCCATTAACACCCCGGATAG|ATCCTCATGATAACCACTTGCCGCCCACAC
ATAACCACTTGCCGCCCACACCCTTAACTA|GGGATAAGGATAAAGGTTAAGCGGGTTCAA
CGATAGTTCGCGGGCATTCTCGGCCGCATT|TTTGACGGGCGCAAGCTTCTGACATGTGGT
TTCGCGTAGCGCCCCCAACGGAACAAATGG|GGTTCAAAAAGCCTGCCACAAAGGTTAAGC
TTAAGCGGGTTCAAAAAGCCTGCCAGCCGA|GGCGGGTTGTACTTGTTGTGTGTGAAGGGG
GGTTCAAAAAGCCTGCCAATAGGGACAAGA|GCCTGCCATCCAGCAGCCCCTGGTTTGCCC
CGCAAAGGTTAAGCGGGTTCAAAAAGCCTG|CCGAGTATTTCAACCGAAAGGTTAAGCGGG
AAGCGGGTTCAAAAAGCCTGCCAACGCTGG|AGCACTGATCTTCCTCTCTCCACCCGGCCA
TCGCGTAGCGCCCCCAACGGAACAAATGGT|GTTCAAAAAGCCTGCCACAAAGGTTAAGCG
CCCTTAACTACGCCCTGCAGGGTCAAGTGA|GCGGGTTCAAAAAGCCTGCCACACTACAAA
CAGCCCCTGGTTTGCCCATTAACACCCCGG|GGTTATCCTCATGATAACCACTTGCCGCCC
TCTCGGCCGCATTTAGAGACCAAAGGTTAA|TCTGACATGTGGTCTTCGCGTAGCGCCCCC
GGGGTGACCAACAAAGGTTAAGCGGGTTCA|TAACTCGAGTTCTGACCTAAGCACTGATCT
AAAGCCTGCCAATCGAGGGATATTTCGTCC|CAAAAAGCCTGCCACCAGTGTATCAAGCAT
GCCTATAGTCCCGAAAAAACGTCAGGATCT|CTCCACGTTCTCTAGATTCTTTTAACACAG
AAAAAGCCTGCCATCCGAATCTTACATGGG|GTTAAGCGGGTTCAAAAAGCCTGCCACTGC
AGACAGTTAGAGCCTATAGTCCCGAAAAAA|TCCCACACTTGCTCCACGTTCTCTAGATTC
AATGCTCCGTAGCGATTCGGGCCAAAGGTT|CCTGGAATGGCTATCTCTGGCCGTGGAGGG
AAAGGTTAAGCGGGTTCAAAAAGCCTGCCA|AAGCGGGTTCAAAAAGCCTGCCAAGCGGGT
AAAAAGCCTGCCACCACACGATGACGATAG|GAATGCGGCAGCGTGCGACCCAAGTTTGAC
AGCCCCTGGTTTGCCCATTAACACCCCGGA|GTTATCCTCATGATAACCACTTGCCGCCCA
ACACATATGAAGATGCCGTCACTTGTAAAG|GCCGCATTTAGAGACCAAAGGTTAAGCGGG
GATGACGATAGTTCGCGGGCATTCTCGGCC|CCAAGTTTGACGGGCGCAAGCTTCTGACAT
CTACAAAAGGTTAAAAGGTTAAGCGGGTTC|TTAAGCGGGTTCAAAAAGCCTGCCATCCGA
GTATCAAGCATGTCGGGTCCCGTAGAAAAC|AATAGGGACAAGAAAGGTTAAGCGGGTTCA
CCGAATCTTACATGGGTGTTGATTTAGTAA|AAAAGCCTGCCACTGCGCCCGATAGTAACC
AGTGAGAGCTTTGCTTTGAAAGGTTAAGCG|ACAAAAGGTTAAAAGGTTAAGCGGGTTCAA
CAATCGTCGGCATCGAACCCTCTTCTTCTT|CACGATGACGATAGTTCGCGGGCATTCTCG
TGCCAAAATAGGGGAACCTTCGCAAAGGTT|GGGTTCAAAAAGCCTGCCAGCCGAGTATTT
CACCACACGATGACGATAGTTCGCGGGCAT|CGTGCGACCCAAGTTTGACGGGCGCAAGCT
ATCGAACCCTCTTCTTCTTACACATATGAA|TAGTTCGCGGGCATTCTCGGCCGCATTTAG
CCCCGGATAGAATGCGGCAGCGTGCGACCC|CCGCCCACACCCTTAACTACGCCCTGCAGG
GTAGCGCCCCCAACGGAACAAATGGTCACG|AAAAAGCCTGCCACAAAGGTTAAGCGGGTT
CGCAAGCTTCTGACATGTGGTCTTCGCGTA|CTTTGCTTTGAAAGGTTAAGCGGGTTCAAA
CCTATAGTCCCGAAAAAACGTCAGGATCTT|TCCACGTTCTCTAGATTCTTTTAACACAGA
AAAGCCTGCCAAAATAGGGGAACCTTCGCA|TTAAGCGGGTTCAAAAAGCCTGCCAGCCGA
GGGTTCAAAAAGCCTGCCACACTACAAAAG|ATAGGGGAACCTTCGCAAAGGTTAAGCGGG
GCGGGTTCAAAAAGCCTGCCAGCCGAGTAT|GGTTGTACTTGTTGTGTGTGAAGGGGACCT
GCCGCCCACACCCTTAACTACGCCCTGCAG|TAAAGGTTAAGCGGGTTCAAAAAGCCTGCC
ATTCGGGCCAAAGGTTAAGCGGGTTCAAAA|CTCTGGCCGTGGAGGGCGGGTTGTACTTGT
CCTGGTTTGCCCATTAACACCCCGGATAGA|TCCTCATGATAACCACTTGCCGCCCACACC
GTTAGAGCCTATAGTCCCGAAAAAACGTCA|CACTTGCTCCACGTTCTCTAGATTCTTTTA
GCCACTGCGCCCGATAGTAACCACTAACCG|GCGGGTTCAAAAAGCCTGCCAACGCTGGTA
TCACTTGTAAAGGTTAAGCGGGTTCAAAAA|AGGTTAAGCGGGTTCAAAAAGCCTGCCATC
TCAAAAAGCCTGCCAAAATAGGGGAACCTT|AAGGTTAAGCGGGTTCAAAAAGCCTGCCAG
CCTCCTGTTCTTCGTAAACCACCTATGATT|ACATATGAGATTTTTAGCAATCGTCGGCAT
GACCCAAGTTTGACGGGCGCAAGCTTCTGA|GCAGGGTCAAGTGAGAGCTTTGCTTTGAAA
TCGTGGAAACCGAAAAGGTTAAGCGGGTTC|CGTCTGGGTTGTAGATAAAGGTTAAGCGGG
AACAAAGGTTAAGCGGGTTCAAAAAGCCTG|TTCTGACCTAAGCACTGATCTTCCTCTCTC
GGTTAAGCGGGTTCAAAAAGCCTGCCAAAA|CGATTCGGGCCAAAGGTTAAGCGGGTTCAA
GTTCAAAAAGCCTGCCACTGCGCCCGATAG|CAACAAAGGTTAAGCGGGTTCAAAAAGCCT
TCAAAAAGCCTGCCACCACACGATGACGAT|TAGAATGCGGCAGCGTGCGACCCAAGTTTG
TACCTCCTGTTCTTCGTAAACCACCTATGA|AAACATATGAGATTTTTAGCAATCGTCGGC
GCGGGTTCAAAAAGCCTGCCAATCGAGGGA|TAAGCGGGTTCAAAAAGCCTGCCACCAGTG
AGAAAACATATGAGATTTTTAGCAATCGTC|GGGTTCAAAAAGCCTGCCACCACACGATGA
TTCGGGCCAAAGGTTAAGCGGGTTCAAAAA|TCTGGCCGTGGAGGGCGGGTTGTACTTGTT
AGCCTGCCAAAATAGGGGAACCTTCGCAAA|AAGCGGGTTCAAAAAGCCTGCCAGCCGAGT
ACGATGACGATAGTTCGCGGGCATTCTCGG|ACCCAAGTTTGACGGGCGCAAGCTTCTGAC
CGAACCCTCTTCTTCTTACACATATGAAGA|GTTCGCGGGCATTCTCGGCCGCATTTAGAG
TCAAGTGAGAGCTTTGCTTTGAAAGGTTAA|ACTACAAAAGGTTAAAAGGTTAAGCGGGTT
CTGCCAACGCTGGTAGTACTTCGACCAAGA|CTCCACCCGGCCAGTTATTAAGAAAGAAAT
CAAAAAGCCTGCCATCCGAATCTTACATGG|GGTTAAGCGGGTTCAAAAAGCCTGCCACTG
GCCAATCGAGGGATATTTCGTCCTTGGCAC|CCTGCCACCAGTGTATCAAGCATGTCGGGT
CGTGGAGGGCGGGTTGTACTTGTTGTGTGT|AGCCTATAGTCCCGAAAAAACGTCAGGATC
AAGGTTAAGCGGGTTCAAAAAGCCTGCCAA|AGCGATTCGGGCCAAAGGTTAAGCGGGTTC
CCGAAAAGGTTAAGCGGGTTCAAAAAGCCT|TGTAGATAAAGGTTAAGCGGGTTCAAAAAG
ACACCCTTAACTACGCCCTGCAGGGTCAAG|TAAGCGGGTTCAAAAAGCCTGCCACACTAC
AATCACTATAACTCGTCTGGGTTGTAGATA|CTTCTTCTTACACATATGAAGATGCCGTCA
CATGGGTGTTGATTTAGTAAGTACCCCCGA|CACTGCGCCCGATAGTAACCACTAACCGGG
CAGTTAGAGCCTATAGTCCCGAAAAAACGT|CACACTTGCTCCACGTTCTCTAGATTCTTT
CGATGACGATAGTTCGCGGGCATTCTCGGC|CCCAAGTTTGACGGGCGCAAGCTTCTGACA
GGGTTCAAAAAGCCTGCCAAGTACGATGAC|GATTTAGTAAGTACCCCCGAAGAATGCTCC
AGGTTAAGCGGGTTCAAAAAGCCTGCCAAC|ACCTAAGCACTGATCTTCCTCTCTCCACCC
TAGAATGCGGCAGCGTGCGACCCAAGTTTG|CACCCTTAACTACGCCCTGCAGGGTCAAGT
CGGGTTCAAAAAGCCTGCCATGTTATGGGA|GCCAAGTACGATGACAAAAGGTTAAGCGGG
ATCCGAATCTTACATGGGTGTTGATTTAGT|CAAAAAGCCTGCCACTGCGCCCGATAGTAA
GTAGTACTTCGACCAAGAAGACAGTTAGAG|AGTTATTAAGAAAGAAATTCCCACACTTGC
GTCAAGTGAGAGCTTTGCTTTGAAAGGTTA|CACTACAAAAGGTTAAAAGGTTAAGCGGGT
GCCTGCCACACTACAAAAGGTTAAAAGGTT|TTCGCAAAGGTTAAGCGGGTTCAAAAAGCC
GTGTGAAGGGGACCTCAATAGGTACAGAGG|GATCTTTGACAAAAGCCCGCAACTTATATA
GAGGGGTGACCAACAAAGGTTAAGCGGGTT|TATAACTCGAGTTCTGACCTAAGCACTGAT
CACCAGTGTATCAAGCATGTCGGGTCCCGT|GCCTGCCAATAGGGACAAGAAAGGTTAAGC
GGGTTCAAAAAGCCTGCCACCAGTGTATCA|TTAAGCGGGTTCAAAAAGCCTGCCAATAGG
AAGGTTAAGCGGGTTCAAAAAGCCTGCCAG|GGAGGGCGGGTTGTACTTGTTGTGTGTGAA
GTTAAGCGGGTTCAAAAAGCCTGCCAAAAT|GATTCGGGCCAAAGGTTAAGCGGGTTCAAA
CAAAGGTTAAGCGGGTTCAAAAAGCCTGCC|GTGGAGGGCGGGTTGTACTTGTTGTGTGTG
GAACCCTCTTCTTCTTACACATATGAAGAT|TTCGCGGGCATTCTCGGCCGCATTTAGAGA
CTCCTGTTCTTCGTAAACCACCTATGATTT|CATATGAGATTTTTAGCAATCGTCGGCATC
AAATAGGGGAACCTTCGCAAAGGTTAAGCG|CAAAAAGCCTGCCAGCCGAGTATTTCAACC
CGGCCGCATTTAGAGACCAAAGGTTAAGCG|GACATGTGGTCTTCGCGTAGCGCCCCCAAC
CAAAAAGCCTGCCACTGCGCCCGATAGTAA|CAAAGGTTAAGCGGGTTCAAAAAGCCTGCC
AGGTTAAGCGGGTTCAAAAAGCCTGCCACC|TTAACACCCCGGATAGAATGCGGCAGCGTG
TCGACCAAGAAGACAGTTAGAGCCTATAGT|AGAAAGAAATTCCCACACTTGCTCCACGTT
GCCTGCCATCCAGCAGCCCCTGGTTTGCCC|GTCACGGATGCCGGGTTATCCTCATGATAA
TCAAAAAGCCTGCCAAGCGGGTTCAAAAAG|GAATCTTACATGGGTGTTGATTTAGTAAGT
GATTTTTCCGGGAATCACTATAACTCGTCT|GCATCGAACCCTCTTCTTCTTACACATATG
GGCATTCTCGGCCGCATTTAGAGACCAAAG|AAGCTTCTGACATGTGGTCTTCGCGTAGCG
GTTAAGCGGGTTCAAAAAGCCTGCCACCAG|GTAAAGGTTAAGCGGGTTCAAAAAGCCTGC
GAACAAATGGTCACGGATGCCGGGTTATCC|AAGGTTAAGCGGGTTCAAAAAGCCTGCCAT
ATGATTTTTCCGGGAATCACTATAACTCGT|CGGCATCGAACCCTCTTCTTCTTACACATA
CTCTTCTTCTTACACATATGAAGATGCCGT|GGGCATTCTCGGCCGCATTTAGAGACCAAA
AGGTTAAGCGGGTTCAAAAAGCCTGCCACA|CCTGCCAAAATAGGGGAACCTTCGCAAAGG
AGGATAAAGGTTAAGCGGGTTCAAAAAGCC|CAAAAAGCCTGCCAAAATAGGGGAACCTTC
GACGATAGTTCGCGGGCATTCTCGGCCGCA|AGTTTGACGGGCGCAAGCTTCTGACATGTG
GGAATGGCTATCTCTGGCCGTGGAGGGCGG|GACCAAGAAGACAGTTAGAGCCTATAGTCC
CCTGTTCTTCGTAAACCACCTATGATTTTT|TATGAGATTTTTAGCAATCGTCGGCATCGA
GATTTAGTAAGTACCCCCGAAGAATGCTCC|GATAGTAACCACTAACCGGGAGCCTGGAAT
AGCCTGCCACAAAGGTTAAGCGGGTTCAAA|CAAGCGGGTTCAAAAAGCCTGCCAAGTACG
CCCACACCCTTAACTACGCCCTGCAGGGTC|GGTTAAGCGGGTTCAAAAAGCCTGCCACAC
CCGAAGAATGCTCCGTAGCGATTCGGGCCA|CGGGAGCCTGGAATGGCTATCTCTGGCCGT
GTTCAAAAAGCCTGCCATCCGAATCTTACA|AAAGGTTAAGCGGGTTCAAAAAGCCTGCCA
CCATGTTATGGGATAAGGATAAAGGTTAAG|AAGGTTAAGCGGGTTCAAAAAGCCTGCCAA
GAGGGATATTTCGTCCTTGGCACCTAGATT|CCAGTGTATCAAGCATGTCGGGTCCCGTAG
AACATATGAGATTTTTAGCAATCGTCGGCA|TCAAAAAGCCTGCCACCACACGATGACGAT
GACATGTGGTCTTCGCGTAGCGCCCCCAAC|AAGGTTAAGCGGGTTCAAAAAGCCTGCCAC
CTGCGCCCGATAGTAACCACTAACCGGGAG|GTTCAAAAAGCCTGCCAACGCTGGTAGTAC
GTTGTACTTGTTGTGTGTGAAGGGGACCTC|CGAAAAAACGTCAGGATCTTTGACAAAAGC
TACTTGTTGTGTGTGAAGGGGACCTCAATA|AAAACGTCAGGATCTTTGACAAAAGCCCGC
GGGTTCAAAAAGCCTGCCATGTTATGGGAT|CCAAGTACGATGACAAAAGGTTAAGCGGGT
GCCAGCCGAGTATTTCAACCGAAAGGTTAA|GTGAAGGGGACCTCAATAGGTACAGAGGGG
CGGGTTCAAAAAGCCTGCCAACGCTGGTAG|ACTGATCTTCCTCTCTCCACCCGGCCAGTT
ATAGGTACAGAGGGGTGACCAACAAAGGTT|CGCAACTTATATAACTCGAGTTCTGACCTA
CCCTCGTATAGCTCAGGCACTTGAGTGTAT|CCTATGATTTTTCCGGGAATCACTATAACT
CTGGGTTGTAGATAAAGGTTAAGCGGGTTC|TGAAGATGCCGTCACTTGTAAAGGTTAAGC
CCGAAAGGTTAAGCGGGTTCAAAAAGCCTG|GGTACAGAGGGGTGACCAACAAAGGTTAAG
ACTTCGACCAAGAAGACAGTTAGAGCCTAT|TTAAGAAAGAAATTCCCACACTTGCTCCAC
CATTTAGAGACCAAAGGTTAAGCGGGTTCA|TGGTCTTCGCGTAGCGCCCCCAACGGAACA
GGCCAAAGGTTAAGCGGGTTCAAAAAGCCT|GCCGTGGAGGGCGGGTTGTACTTGTTGTGT
CGGGTCCCGTAGAAAACATATGAGATTTTT|AAGGTTAAGCGGGTTCAAAAAGCCTGCCAC
GGGATAAGGATAAAGGTTAAGCGGGTTCAA|CGGGTTCAAAAAGCCTGCCAAAATAGGGGA
GCAGCGTGCGACCCAAGTTTGACGGGCGCA|CTACGCCCTGCAGGGTCAAGTGAGAGCTTT
CAAAATAGGGGAACCTTCGCAAAGGTTAAG|TTCAAAAAGCCTGCCAGCCGAGTATTTCAA
CTGGTAGTACTTCGACCAAGAAGACAGTTA|GCCAGTTATTAAGAAAGAAATTCCCACACT
CCTGCCACTGCGCCCGATAGTAACCACTAA|TAAGCGGGTTCAAAAAGCCTGCCAACGCTG
GCCTGCCATGTTATGGGATAAGGATAAAGG|GACAAAAGGTTAAGCGGGTTCAAAAAGCCT
TCAAAAAGCCTGCCACTGCGCCCGATAGTA|ACAAAGGTTAAGCGGGTTCAAAAAGCCTGC
TTAGAGCCTATAGTCCCGAAAAAACGTCAG|ACTTGCTCCACGTTCTCTAGATTCTTTTAA
CATGTCGGGTCCCGTAGAAAACATATGAGA|CAAGAAAGGTTAAGCGGGTTCAAAAAGCCT
AAAAAGCCTGCCATGTTATGGGATAAGGAT|ACGATGACAAAAGGTTAAGCGGGTTCAAAA
CACACTACAAAAGGTTAAAAGGTTAAGCGG|AAGGTTAAGCGGGTTCAAAAAGCCTGCCAT
CACTAACCGGGAGCCTGGAATGGCTATCTC|ACGCTGGTAGTACTTCGACCAAGAAGACAG
TTCAAAAAGCCTGCCAAAATAGGGGAACCT|AAAGGTTAAGCGGGTTCAAAAAGCCTGCCA
TAACCGGGAGCCTGGAATGGCTATCTCTGG|CTGGTAGTACTTCGACCAAGAAGACAGTTA
ACCGAAAAGGTTAAGCGGGTTCAAAAAGCC|TTGTAGATAAAGGTTAAGCGGGTTCAAAAA
CAAAAAGCCTGCCACAAAGGTTAAGCGGGT|CCTGCCAAGCGGGTTCAAAAAGCCTGCCAA
GTACCCCCGAAGAATGCTCCGTAGCGATTC|ACTAACCGGGAGCCTGGAATGGCTATCTCT
TATAGCTCAGGCACTTGAGTGTATTCGTGG|ATTTTTCCGGGAATCACTATAACTCGTCTG
TTGTAGATAAAGGTTAAGCGGGTTCAAAAA|ATGCCGTCACTTGTAAAGGTTAAGCGGGTT
AGCGGGTTCAAAAAGCCTGCCATGTTATGG|CTGCCAAGTACGATGACAAAAGGTTAAGCG
AAAGGTTAAGCGGGTTCAAAAAGCCTGCCA|AGTATTTCAACCGAAAGGTTAAGCGGGTTC
TGGCACCTAGATTATACCTCCTGTTCTTCG|TCGGGTCCCGTAGAAAACATATGAGATTTT
AGTATTTCAACCGAAAGGTTAAGCGGGTTC|GACCTCAATAGGTACAGAGGGGTGACCAAC
CGGGTTCAAAAAGCCTGCCACTGCGCCCGA|GACCAACAAAGGTTAAGCGGGTTCAAAAAG
ATCAAGCATGTCGGGTCCCGTAGAAAACAT|TAGGGACAAGAAAGGTTAAGCGGGTTCAAA
CTATGATTTTTCCGGGAATCACTATAACTC|GTCGGCATCGAACCCTCTTCTTCTTACACA
TGTACTTGTTGTGTGTGAAGGGGACCTCAA|AAAAAACGTCAGGATCTTTGACAAAAGCCC
AGGTTAAGCGGGTTCAAAAAGCCTGCCAAT|GGTTCAAAAAGCCTGCCATCCAGCAGCCCC
AAAAGCCTGCCAAAATAGGGGAACCTTCGC|GTTAAGCGGGTTCAAAAAGCCTGCCAGCCG
CATCCAGCAGCCCCTGGTTTGCCCATTAAC|GATGCCGGGTTATCCTCATGATAACCACTT
GCCTGCCAGCCGAGTATTTCAACCGAAAGG|GTGTGTGAAGGGGACCTCAATAGGTACAGA
TCAACCGAAAGGTTAAGCGGGTTCAAAAAG|AATAGGTACAGAGGGGTGACCAACAAAGGT
GTTAAGCGGGTTCAAAAAGCCTGCCAACGC|CTAAGCACTGATCTTCCTCTCTCCACCCGG
TGAGAGCTTTGCTTTGAAAGGTTAAGCGGG|AAAAGGTTAAAAGGTTAAGCGGGTTCAAAA
CCCCTCGTATAGCTCAGGCACTTGAGTGTA|ACCTATGATTTTTCCGGGAATCACTATAAC
AAAAAGCCTGCCAATCGAGGGATATTTCGT|TTCAAAAAGCCTGCCACCAGTGTATCAAGC
ATGCTCCGTAGCGATTCGGGCCAAAGGTTA|CTGGAATGGCTATCTCTGGCCGTGGAGGGC
AAGTACCCCCGAAGAATGCTCCGTAGCGAT|CCACTAACCGGGAGCCTGGAATGGCTATCT
ATATGAGATTTTTAGCAATCGTCGGCATCG|AAAAGCCTGCCACCACACGATGACGATAGT
CCGAGTATTTCAACCGAAAGGTTAAGCGGG|GGGGACCTCAATAGGTACAGAGGGGTGACC
AAGAATGCTCCGTAGCGATTCGGGCCAAAG|GAGCCTGGAATGGCTATCTCTGGCCGTGGA
CTGCCACCACACGATGACGATAGTTCGCGG|GCAGCGTGCGACCCAAGTTTGACGGGCGCA
AGGGGACCTCAATAGGTACAGAGGGGTGAC|TGACAAAAGCCCGCAACTTATATAACTCGA
CCACAAAGGTTAAGCGGGTTCAAAAAGCCT|GGTTCAAAAAGCCTGCCAAGTACGATGACA
AGCCTATAGTCCCGAAAAAACGTCAGGATC|GCTCCACGTTCTCTAGATTCTTTTAACACA
ACCCCGGATAGAATGCGGCAGCGTGCGACC|GCCGCCCACACCCTTAACTACGCCCTGCAG
CTTCGACCAAGAAGACAGTTAGAGCCTATA|TAAGAAAGAAATTCCCACACTTGCTCCACG
TCAAAAAGCCTGCCAGCCGAGTATTTCAAC|ACTTGTTGTGTGTGAAGGGGACCTCAATAG
TTGATTTAGTAAGTACCCCCGAAGAATGCT|CCGATAGTAACCACTAACCGGGAGCCTGGA
GCCTGCCAAAATAGGGGAACCTTCGCAAAG|AGCGGGTTCAAAAAGCCTGCCAGCCGAGTA
CCTGCCACCACACGATGACGATAGTTCGCG|GGCAGCGTGCGACCCAAGTTTGACGGGCGC
GACAGTTAGAGCCTATAGTCCCGAAAAAAC|CCCACACTTGCTCCACGTTCTCTAGATTCT
TTATGGGATAAGGATAAAGGTTAAGCGGGT|TAAGCGGGTTCAAAAAGCCTGCCAAAATAG
GTTGTAGATAAAGGTTAAGCGGGTTCAAAA|GATGCCGTCACTTGTAAAGGTTAAGCGGGT
CAGCAGCCCCTGGTTTGCCCATTAACACCC|CCGGGTTATCCTCATGATAACCACTTGCCG
TGCCGTCACTTGTAAAGGTTAAGCGGGTTC|ACCAAAGGTTAAGCGGGTTCAAAAAGCCTG
CTTCGCGTAGCGCCCCCAACGGAACAAATG|GGGTTCAAAAAGCCTGCCACAAAGGTTAAG
ACACCCCGGATAGAATGCGGCAGCGTGCGA|TTGCCGCCCACACCCTTAACTACGCCCTGC
GGGAATCACTATAACTCGTCTGGGTTGTAG|CCTCTTCTTCTTACACATATGAAGATGCCG
TGAAAGGTTAAGCGGGTTCAAAAAGCCTGC|TTAAGCGGGTTCAAAAAGCCTGCCAAGCGG
TGTATTCGTGGAAACCGAAAAGGTTAAGCG|TAACTCGTCTGGGTTGTAGATAAAGGTTAA
CGGGCGCAAGCTTCTGACATGTGGTCTTCG|AGAGCTTTGCTTTGAAAGGTTAAGCGGGTT
GAGTATTTCAACCGAAAGGTTAAGCGGGTT|GGACCTCAATAGGTACAGAGGGGTGACCAA
TGGCCGTGGAGGGCGGGTTGTACTTGTTGT|TTAGAGCCTATAGTCCCGAAAAAACGTCAG
CCTTCGCAAAGGTTAAGCGGGTTCAAAAAG|CCAGCCGAGTATTTCAACCGAAAGGTTAAG
GCCCACACCCTTAACTACGCCCTGCAGGGT|AGGTTAAGCGGGTTCAAAAAGCCTGCCACA
AAGCGGGTTCAAAAAGCCTGCCATGTTATG|CCTGCCAAGTACGATGACAAAAGGTTAAGC
TCCCGTAGAAAACATATGAGATTTTTAGCA|TTAAGCGGGTTCAAAAAGCCTGCCACCACA
AAAAAGCCTGCCAATAGGGACAAGAAAGGT|CCATCCAGCAGCCCCTGGTTTGCCCATTAA
AAGCCTGCCAATCGAGGGATATTTCGTCCT|AAAAAGCCTGCCACCAGTGTATCAAGCATG
GTGACCAACAAAGGTTAAGCGGGTTCAAAA|CTCGAGTTCTGACCTAAGCACTGATCTTCC
AAGCGGGTTCAAAAAGCCTGCCAGCCGAGT|CGGGTTGTACTTGTTGTGTGTGAAGGGGAC
GAGACCAAAGGTTAAGCGGGTTCAAAAAGC|TCGCGTAGCGCCCCCAACGGAACAAATGGT
CACTACAAAAGGTTAAAAGGTTAAGCGGGT|GGTTAAGCGGGTTCAAAAAGCCTGCCATCC
CTGCCACACTACAAAAGGTTAAAAGGTTAA|CGCAAAGGTTAAGCGGGTTCAAAAAGCCTG
ACCACACGATGACGATAGTTCGCGGGCATT|GTGCGACCCAAGTTTGACGGGCGCAAGCTT
AGAGCCTATAGTCCCGAAAAAACGTCAGGA|TTGCTCCACGTTCTCTAGATTCTTTTAACA
TATGGGATAAGGATAAAGGTTAAGCGGGTT|AAGCGGGTTCAAAAAGCCTGCCAAAATAGG
GGGTTCAAAAAGCCTGCCAATCGAGGGATA|AGCGGGTTCAAAAAGCCTGCCACCAGTGTA
TAACACCCCGGATAGAATGCGGCAGCGTGC|ACTTGCCGCCCACACCCTTAACTACGCCCT
TCAAAAAGCCTGCCATGTTATGGGATAAGG|GTACGATGACAAAAGGTTAAGCGGGTTCAA
AAGCCTGCCACTGCGCCCGATAGTAACCAC|GGTTAAGCGGGTTCAAAAAGCCTGCCAACG
GGTTAAGCGGGTTCAAAAAGCCTGCCATGT|AAAGCCTGCCAAGTACGATGACAAAAGGTT
GCCTGCCAAGTACGATGACAAAAGGTTAAG|TACCCCCGAAGAATGCTCCGTAGCGATTCG
GCCGCATTTAGAGACCAAAGGTTAAGCGGG|CATGTGGTCTTCGCGTAGCGCCCCCAACGG
TCGAGGGATATTTCGTCCTTGGCACCTAGA|CACCAGTGTATCAAGCATGTCGGGTCCCGT
AATAGGGACAAGAAAGGTTAAGCGGGTTCA|CCCTGGTTTGCCCATTAACACCCCGGATAG
CCGAAAAAACGTCAGGATCTTTGACAAAAG|TCTAGATTCTTTTAACACAGATGTCCTCAA
TAGCTCAGGCACTTGAGTGTATTCGTGGAA|TTTTCCGGGAATCACTATAACTCGTCTGGG
TAGAGCCTATAGTCCCGAAAAAACGTCAGG|CTTGCTCCACGTTCTCTAGATTCTTTTAAC
AGTTCGCGGGCATTCTCGGCCGCATTTAGA|ACGGGCGCAAGCTTCTGACATGTGGTCTTC
CCCAACGGAACAAATGGTCACGGATGCCGG|TGCCACAAAGGTTAAGCGGGTTCAAAAAGC
GCCATGTTATGGGATAAGGATAAAGGTTAA|AAAGGTTAAGCGGGTTCAAAAAGCCTGCCA
AAGCGGGTTCAAAAAGCCTGCCAAAATAGG|TCGGGCCAAAGGTTAAGCGGGTTCAAAAAG
GTCGGGTCCCGTAGAAAACATATGAGATTT|GAAAGGTTAAGCGGGTTCAAAAAGCCTGCC
ATAGGGGAACCTTCGCAAAGGTTAAGCGGG|AAAAGCCTGCCAGCCGAGTATTTCAACCGA
AGCCTGCCAAGTACGATGACAAAAGGTTAA|GTACCCCCGAAGAATGCTCCGTAGCGATTC
CTCAATAGGTACAGAGGGGTGACCAACAAA|AGCCCGCAACTTATATAACTCGAGTTCTGA
TTTGCTTTGAAAGGTTAAGCGGGTTCAAAA|TAAAAGGTTAAGCGGGTTCAAAAAGCCTGC
AAGTACGATGACAAAAGGTTAAGCGGGTTC|GAAGAATGCTCCGTAGCGATTCGGGCCAAA
ATAGGGACAAGAAAGGTTAAGCGGGTTCAA|CCTGGTTTGCCCATTAACACCCCGGATAGA
ATAACTCGTCTGGGTTGTAGATAAAGGTTA|TTACACATATGAAGATGCCGTCACTTGTAA
GTACGATGACAAAAGGTTAAGCGGGTTCAA|AGAATGCTCCGTAGCGATTCGGGCCAAAGG
CCCCCGAAGAATGCTCCGTAGCGATTCGGG|AACCGGGAGCCTGGAATGGCTATCTCTGGC
GCTCAGGCACTTGAGTGTATTCGTGGAAAC|TTCCGGGAATCACTATAACTCGTCTGGGTT
CGGGTTCAAAAAGCCTGCCAAGCGGGTTCA|CATCCGAATCTTACATGGGTGTTGATTTAG
TAACTACGCCCTGCAGGGTCAAGTGAGAGC|GTTCAAAAAGCCTGCCACACTACAAAAGGT
GGCACCTAGATTATACCTCCTGTTCTTCGT|CGGGTCCCGTAGAAAACATATGAGATTTTT
TTCAAAAAGCCTGCCATCCAGCAGCCCCTG|AACAAATGGTCACGGATGCCGGGTTATCCT
TTCTTACACATATGAAGATGCCGTCACTTG|TCTCGGCCGCATTTAGAGACCAAAGGTTAA
CACTTGTAAAGGTTAAGCGGGTTCAAAAAG|GGTTAAGCGGGTTCAAAAAGCCTGCCATCC
CAACGGAACAAATGGTCACGGATGCCGGGT|CCACAAAGGTTAAGCGGGTTCAAAAAGCCT
AGTCCCGAAAAAACGTCAGGATCTTTGACA|GTTCTCTAGATTCTTTTAACACAGATGTCC
TCGGGCCAAAGGTTAAGCGGGTTCAAAAAG|CTGGCCGTGGAGGGCGGGTTGTACTTGTTG
AAAGGTTAAGCGGGTTCAAAAAGCCTGCCA|AGCCTGCCAAAATAGGGGAACCTTCGCAAA
AAGGTTAAAAGGTTAAGCGGGTTCAAAAAG|GGGTTCAAAAAGCCTGCCATCCGAATCTTA
GTCACGGATGCCGGGTTATCCTCATGATAA|CGGGTTCAAAAAGCCTGCCATGTTATGGGA
TCTTACATGGGTGTTGATTTAGTAAGTACC|CCTGCCACTGCGCCCGATAGTAACCACTAA
AAAGGTTAAGCGGGTTCAAAAAGCCTGCCA|CATTAACACCCCGGATAGAATGCGGCAGCG
AGCGCCCCCAACGGAACAAATGGTCACGGA|AAAGCCTGCCACAAAGGTTAAGCGGGTTCA
GGTTGTACTTGTTGTGTGTGAAGGGGACCT|CCGAAAAAACGTCAGGATCTTTGACAAAAG
AAAAGCCTGCCACACTACAAAAGGTTAAAA|AACCTTCGCAAAGGTTAAGCGGGTTCAAAA
CTCATGATAACCACTTGCCGCCCACACCCT|TGTTATGGGATAAGGATAAAGGTTAAGCGG
AAAGCCTGCCAGCCGAGTATTTCAACCGAA|GTTGTGTGTGAAGGGGACCTCAATAGGTAC
GAAGGGGACCTCAATAGGTACAGAGGGGTG|TTTGACAAAAGCCCGCAACTTATATAACTC
TGCAGGGTCAAGTGAGAGCTTTGCTTTGAA|CTGCCACACTACAAAAGGTTAAAAGGTTAA
TGTGAAGGGGACCTCAATAGGTACAGAGGG|ATCTTTGACAAAAGCCCGCAACTTATATAA
AGCGGGTTCAAAAAGCCTGCCAATAGGGAC|AAAAGCCTGCCATCCAGCAGCCCCTGGTTT
CAAGCGGGTTCAAAAAGCCTGCCAAGTACG|GTGTTGATTTAGTAAGTACCCCCGAAGAAT
AGGTTAAGCGGGTTCAAAAAGCCTGCCAAG|AAGCCTGCCATCCGAATCTTACATGGGTGT
AGACCAAAGGTTAAGCGGGTTCAAAAAGCC|CGCGTAGCGCCCCCAACGGAACAAATGGTC
CCATCCGAATCTTACATGGGTGTTGATTTA|TTCAAAAAGCCTGCCACTGCGCCCGATAGT
CGAAAAGGTTAAGCGGGTTCAAAAAGCCTG|GTAGATAAAGGTTAAGCGGGTTCAAAAAGC
TTCGTCCTTGGCACCTAGATTATACCTCCT|CAAGCATGTCGGGTCCCGTAGAAAACATAT
GTTCTTCGTAAACCACCTATGATTTTTCCG|GAGATTTTTAGCAATCGTCGGCATCGAACC
ATCACTATAACTCGTCTGGGTTGTAGATAA|TTCTTCTTACACATATGAAGATGCCGTCAC
ATTTTTAGCAATCGTCGGCATCGAACCCTC|TGCCACCACACGATGACGATAGTTCGCGGG
TGACATGTGGTCTTCGCGTAGCGCCCCCAA|AAAGGTTAAGCGGGTTCAAAAAGCCTGCCA
GGCCGTGGAGGGCGGGTTGTACTTGTTGTG|TAGAGCCTATAGTCCCGAAAAAACGTCAGG
CCCGATAGTAACCACTAACCGGGAGCCTGG|AAAAGCCTGCCAACGCTGGTAGTACTTCGA
GCCACACTACAAAAGGTTAAAAGGTTAAGC|CAAAGGTTAAGCGGGTTCAAAAAGCCTGCC
GGCTATCTCTGGCCGTGGAGGGCGGGTTGT|AGAAGACAGTTAGAGCCTATAGTCCCGAAA
GCATTTAGAGACCAAAGGTTAAGCGGGTTC|GTGGTCTTCGCGTAGCGCCCCCAACGGAAC
GCCTGCCATCCGAATCTTACATGGGTGTTG|GCGGGTTCAAAAAGCCTGCCACTGCGCCCG
GTTAAGCGGGTTCAAAAAGCCTGCCACAAA|GGGTTCAAAAAGCCTGCCAAGCGGGTTCAA
AGCGGGTTCAAAAAGCCTGCCACAAAGGTT|TCAAAAAGCCTGCCAAGCGGGTTCAAAAAG
AAAAGGTTAAGCGGGTTCAAAAAGCCTGCC|AAAAAGCCTGCCATCCGAATCTTACATGGG
CTTGTAAAGGTTAAGCGGGTTCAAAAAGCC|TTAAGCGGGTTCAAAAAGCCTGCCATCCAG
AAAAAGCCTGCCACTGCGCCCGATAGTAAC|AAAGGTTAAGCGGGTTCAAAAAGCCTGCCA
TCTGACATGTGGTCTTCGCGTAGCGCCCCC|TGAAAGGTTAAGCGGGTTCAAAAAGCCTGC
ATGAGATTTTTAGCAATCGTCGGCATCGAA|AAGCCTGCCACCACACGATGACGATAGTTC
GTTAAGCGGGTTCAAAAAGCCTGCCATCCA|CCCCCAACGGAACAAATGGTCACGGATGCC
ACCAACAAAGGTTAAGCGGGTTCAAAAAGC|GAGTTCTGACCTAAGCACTGATCTTCCTCT
CAGGTGTCTTCCCCTCGTATAGCTCAGGCA|TTCGTAAACCACCTATGATTTTTCCGGGAA
TAGATTATACCTCCTGTTCTTCGTAAACCA|CCGTAGAAAACATATGAGATTTTTAGCAAT
TGCTTTGAAAGGTTAAGCGGGTTCAAAAAG|AAAGGTTAAGCGGGTTCAAAAAGCCTGCCA
CAGAGGGGTGACCAACAAAGGTTAAGCGGG|TATATAACTCGAGTTCTGACCTAAGCACTG
TGCGACCCAAGTTTGACGGGCGCAAGCTTC|CCTGCAGGGTCAAGTGAGAGCTTTGCTTTG
GCGGGTTCAAAAAGCCTGCCAAAATAGGGG|GGGCCAAAGGTTAAGCGGGTTCAAAAAGCC
CCTTGGCACCTAGATTATACCTCCTGTTCT|ATGTCGGGTCCCGTAGAAAACATATGAGAT
CCTGCCACACTACAAAAGGTTAAAAGGTTA|TCGCAAAGGTTAAGCGGGTTCAAAAAGCCT
TATTTCGTCCTTGGCACCTAGATTATACCT|TATCAAGCATGTCGGGTCCCGTAGAAAACA
GGTTATCCTCATGATAACCACTTGCCGCCC|CCTGCCATGTTATGGGATAAGGATAAAGGT
CAAGAAAGGTTAAGCGGGTTCAAAAAGCCT|TGCCCATTAACACCCCGGATAGAATGCGGC
GGGAACCTTCGCAAAGGTTAAGCGGGTTCA|GCCTGCCAGCCGAGTATTTCAACCGAAAGG
AAGCGGGTTCAAAAAGCCTGCCACCACACG|ACCCCGGATAGAATGCGGCAGCGTGCGACC
GAGTGTATTCGTGGAAACCGAAAAGGTTAA|CTATAACTCGTCTGGGTTGTAGATAAAGGT
GGGCCAAAGGTTAAGCGGGTTCAAAAAGCC|GGCCGTGGAGGGCGGGTTGTACTTGTTGTG
GTCTGGGTTGTAGATAAAGGTTAAGCGGGT|TATGAAGATGCCGTCACTTGTAAAGGTTAA
AAGCGGGTTCAAAAAGCCTGCCAATCGAGG|GTTAAGCGGGTTCAAAAAGCCTGCCACCAG
TAACCACTAACCGGGAGCCTGGAATGGCTA|GCCAACGCTGGTAGTACTTCGACCAAGAAG
CCGTCACTTGTAAAGGTTAAGCGGGTTCAA|CAAAGGTTAAGCGGGTTCAAAAAGCCTGCC
CAAAAAGCCTGCCAGCCGAGTATTTCAACC|CTTGTTGTGTGTGAAGGGGACCTCAATAGG
CTATAACTCGTCTGGGTTGTAGATAAAGGT|TCTTACACATATGAAGATGCCGTCACTTGT
CAAAGGTTAAGCGGGTTCAAAAAGCCTGCC|TCAAAAAGCCTGCCAAGTACGATGACAAAA
TAGTAAGTACCCCCGAAGAATGCTCCGTAG|GTAACCACTAACCGGGAGCCTGGAATGGCT
GGATATTTCGTCCTTGGCACCTAGATTATA|GTGTATCAAGCATGTCGGGTCCCGTAGAAA
CATGATAACCACTTGCCGCCCACACCCTTA|TTATGGGATAAGGATAAAGGTTAAGCGGGT
GGGTTCAAAAAGCCTGCCACTGCGCCCGAT|ACCAACAAAGGTTAAGCGGGTTCAAAAAGC
TTGTGTGTGAAGGGGACCTCAATAGGTACA|TCAGGATCTTTGACAAAAGCCCGCAACTTA
AAGCGGGTTCAAAAAGCCTGCCAAGTACGA|TGTTGATTTAGTAAGTACCCCCGAAGAATG
GTGTTGATTTAGTAAGTACCCCCGAAGAAT|CGCCCGATAGTAACCACTAACCGGGAGCCT
CGTATAGCTCAGGCACTTGAGTGTATTCGT|TGATTTTTCCGGGAATCACTATAACTCGTC
AAAAAACGTCAGGATCTTTGACAAAAGCCC|AGATTCTTTTAACACAGATGTCCTCAATGA
TTGTAAAGGTTAAGCGGGTTCAAAAAGCCT|TAAGCGGGTTCAAAAAGCCTGCCATCCAGC
CCGTAGCGATTCGGGCCAAAGGTTAAGCGG|ATGGCTATCTCTGGCCGTGGAGGGCGGGTT
TTCTTCTTACACATATGAAGATGCCGTCAC|CATTCTCGGCCGCATTTAGAGACCAAAGGT
CGGGTTCAAAAAGCCTGCCAAAATAGGGGA|GGCCAAAGGTTAAGCGGGTTCAAAAAGCCT
TTCGTGGAAACCGAAAAGGTTAAGCGGGTT|TCGTCTGGGTTGTAGATAAAGGTTAAGCGG
GGTTCAAAAAGCCTGCCACCAGTGTATCAA|TAAGCGGGTTCAAAAAGCCTGCCAATAGGG
TAACTCGTCTGGGTTGTAGATAAAGGTTAA|TACACATATGAAGATGCCGTCACTTGTAAA
AAAAGCCTGCCATGTTATGGGATAAGGATA|CGATGACAAAAGGTTAAGCGGGTTCAAAAA
GGTTCAAAAAGCCTGCCATGTTATGGGATA|CAAGTACGATGACAAAAGGTTAAGCGGGTT
AAGGTTAAGCGGGTTCAAAAAGCCTGCCAA|AAAGCCTGCCATCCGAATCTTACATGGGTG
GCATCGAACCCTCTTCTTCTTACACATATG|GATAGTTCGCGGGCATTCTCGGCCGCATTT
CCACCTATGATTTTTCCGGGAATCACTATA|AATCGTCGGCATCGAACCCTCTTCTTCTTA
CAACGCTGGTAGTACTTCGACCAAGAAGAC|ACCCGGCCAGTTATTAAGAAAGAAATTCCC
TCTTACACATATGAAGATGCCGTCACTTGT|CTCGGCCGCATTTAGAGACCAAAGGTTAAG
AAGGTTAAGCGGGTTCAAAAAGCCTGCCAA|ATAAAGGTTAAGCGGGTTCAAAAAGCCTGC
CCACACTACAAAAGGTTAAAAGGTTAAGCG|AAAGGTTAAGCGGGTTCAAAAAGCCTGCCA
TCGCGGGCATTCTCGGCCGCATTTAGAGAC|GGCGCAAGCTTCTGACATGTGGTCTTCGCG
TTCAAAAAGCCTGCCAGCCGAGTATTTCAA|TACTTGTTGTGTGTGAAGGGGACCTCAATA
AAAGGTTAAGCGGGTTCAAAAAGCCTGCCA|ACAGAGGGGTGACCAACAAAGGTTAAGCGG
GTTCAAAAAGCCTGCCAATCGAGGGATATT|CGGGTTCAAAAAGCCTGCCACCAGTGTATC
CGAGGGATATTTCGTCCTTGGCACCTAGAT|ACCAGTGTATCAAGCATGTCGGGTCCCGTA
TTTCAACCGAAAGGTTAAGCGGGTTCAAAA|TCAATAGGTACAGAGGGGTGACCAACAAAG
ATGTTATGGGATAAGGATAAAGGTTAAGCG|GGTTAAGCGGGTTCAAAAAGCCTGCCAAAA
AGGTTAAGCGGGTTCAAAAAGCCTGCCACC|TTGTAAAGGTTAAGCGGGTTCAAAAAGCCT
ACCCTTAACTACGCCCTGCAGGGTCAAGTG|AGCGGGTTCAAAAAGCCTGCCACACTACAA
GGAACAAATGGTCACGGATGCCGGGTTATC|AAAGGTTAAGCGGGTTCAAAAAGCCTGCCA
TGCCAATCGAGGGATATTTCGTCCTTGGCA|GCCTGCCACCAGTGTATCAAGCATGTCGGG
TCGTCCTTGGCACCTAGATTATACCTCCTG|AAGCATGTCGGGTCCCGTAGAAAACATATG
ACACTACAAAAGGTTAAAAGGTTAAGCGGG|AGGTTAAGCGGGTTCAAAAAGCCTGCCATC
AAAGCCTGCCAATAGGGACAAGAAAGGTTA|ATCCAGCAGCCCCTGGTTTGCCCATTAACA
AAGGTTAAGCGGGTTCAAAAAGCCTGCCAC|AGCGGGTTCAAAAAGCCTGCCAAGCGGGTT
AAAAAGCCTGCCAGCCGAGTATTTCAACCG|TTGTTGTGTGTGAAGGGGACCTCAATAGGT
CTGCAGGGTCAAGTGAGAGCTTTGCTTTGA|CCTGCCACACTACAAAAGGTTAAAAGGTTA
AGCCTGCCATCCAGCAGCCCCTGGTTTGCC|GGTCACGGATGCCGGGTTATCCTCATGATA
AAAGCCTGCCATCCGAATCTTACATGGGTG|TAAGCGGGTTCAAAAAGCCTGCCACTGCGC
TGACGGGCGCAAGCTTCTGACATGTGGTCT|GTGAGAGCTTTGCTTTGAAAGGTTAAGCGG
GATATTTCGTCCTTGGCACCTAGATTATAC|TGTATCAAGCATGTCGGGTCCCGTAGAAAA
AGTACTTCGACCAAGAAGACAGTTAGAGCC|TTATTAAGAAAGAAATTCCCACACTTGCTC
TGCCATGTTATGGGATAAGGATAAAGGTTA|AAAAGGTTAAGCGGGTTCAAAAAGCCTGCC
GTTCAAAAAGCCTGCCAAAATAGGGGAACC|CAAAGGTTAAGCGGGTTCAAAAAGCCTGCC
AAGAAAGGTTAAGCGGGTTCAAAAAGCCTG|GCCCATTAACACCCCGGATAGAATGCGGCA
CGAAAAAACGTCAGGATCTTTGACAAAAGC|CTAGATTCTTTTAACACAGATGTCCTCAAT
TACTTCGACCAAGAAGACAGTTAGAGCCTA|ATTAAGAAAGAAATTCCCACACTTGCTCCA
CCTGCCAATAGGGACAAGAAAGGTTAAGCG|AGCAGCCCCTGGTTTGCCCATTAACACCCC
CGTAAACCACCTATGATTTTTCCGGGAATC|TTTAGCAATCGTCGGCATCGAACCCTCTTC
CCTGCAGGGTCAAGTGAGAGCTTTGCTTTG|GCCTGCCACACTACAAAAGGTTAAAAGGTT
ATGGCTATCTCTGGCCGTGGAGGGCGGGTT|CAAGAAGACAGTTAGAGCCTATAGTCCCGA
GGAGGGCGGGTTGTACTTGTTGTGTGTGAA|CTATAGTCCCGAAAAAACGTCAGGATCTTT
TTAAGCGGGTTCAAAAAGCCTGCCAATCGA|AGGTTAAGCGGGTTCAAAAAGCCTGCCACC
GCCAAAATAGGGGAACCTTCGCAAAGGTTA|GGTTCAAAAAGCCTGCCAGCCGAGTATTTC
AAGCGGGTTCAAAAAGCCTGCCACAAAGGT|TTCAAAAAGCCTGCCAAGCGGGTTCAAAAA
CGTCTGGGTTGTAGATAAAGGTTAAGCGGG|ATATGAAGATGCCGTCACTTGTAAAGGTTA
GGATAAGGATAAAGGTTAAGCGGGTTCAAA|GGGTTCAAAAAGCCTGCCAAAATAGGGGAA
AGGGTCAAGTGAGAGCTTTGCTTTGAAAGG|CCACACTACAAAAGGTTAAAAGGTTAAGCG
GAGATTTTTAGCAATCGTCGGCATCGAACC|GCCTGCCACCACACGATGACGATAGTTCGC
TGGGTGTTGATTTAGTAAGTACCCCCGAAG|CTGCGCCCGATAGTAACCACTAACCGGGAG
AACCACCTATGATTTTTCCGGGAATCACTA|GCAATCGTCGGCATCGAACCCTCTTCTTCT
ATGAAGATGCCGTCACTTGTAAAGGTTAAG|TTTAGAGACCAAAGGTTAAGCGGGTTCAAA
ACAAAAGGTTAAGCGGGTTCAAAAAGCCTG|CCGTAGCGATTCGGGCCAAAGGTTAAGCGG
AAGCCTGCCAGCCGAGTATTTCAACCGAAA|TTGTGTGTGAAGGGGACCTCAATAGGTACA
CACAAAGGTTAAGCGGGTTCAAAAAGCCTG|GTTCAAAAAGCCTGCCAAGTACGATGACAA
CCAACGGAACAAATGGTCACGGATGCCGGG|GCCACAAAGGTTAAGCGGGTTCAAAAAGCC
GATGACAAAAGGTTAAGCGGGTTCAAAAAG|TGCTCCGTAGCGATTCGGGCCAAAGGTTAA
TCGTAAACCACCTATGATTTTTCCGGGAAT|TTTTAGCAATCGTCGGCATCGAACCCTCTT
CCTGCCAACGCTGGTAGTACTTCGACCAAG|TCTCCACCCGGCCAGTTATTAAGAAAGAAA
GGGTTCAAAAAGCCTGCCAATAGGGACAAG|AGCCTGCCATCCAGCAGCCCCTGGTTTGCC
AAGCCTGCCACCAGTGTATCAAGCATGTCG|TTCAAAAAGCCTGCCAATAGGGACAAGAAA
TGATTTAGTAAGTACCCCCGAAGAATGCTC|CGATAGTAACCACTAACCGGGAGCCTGGAA
TGAAGGGGACCTCAATAGGTACAGAGGGGT|CTTTGACAAAAGCCCGCAACTTATATAACT
CCCAAGTTTGACGGGCGCAAGCTTCTGACA|AGGGTCAAGTGAGAGCTTTGCTTTGAAAGG
AGCTTTGCTTTGAAAGGTTAAGCGGGTTCA|GGTTAAAAGGTTAAGCGGGTTCAAAAAGCC
TCACTATAACTCGTCTGGGTTGTAGATAAA|TCTTCTTACACATATGAAGATGCCGTCACT
AAGCCTGCCAAGCGGGTTCAAAAAGCCTGC|TTACATGGGTGTTGATTTAGTAAGTACCCC
TAAGCGGGTTCAAAAAGCCTGCCAATCGAG|GGTTAAGCGGGTTCAAAAAGCCTGCCACCA
TCCAGCAGCCCCTGGTTTGCCCATTAACAC|TGCCGGGTTATCCTCATGATAACCACTTGC
AGCTCAGGCACTTGAGTGTATTCGTGGAAA|TTTCCGGGAATCACTATAACTCGTCTGGGT
AAGGTTAAGCGGGTTCAAAAAGCCTGCCAT|GTATTTCAACCGAAAGGTTAAGCGGGTTCA
GTTAAGCGGGTTCAAAAAGCCTGCCACACT|TGCCAAAATAGGGGAACCTTCGCAAAGGTT
GTTTGCCCATTAACACCCCGGATAGAATGC|CATGATAACCACTTGCCGCCCACACCCTTA
GTAGATAAAGGTTAAGCGGGTTCAAAAAGC|GCCGTCACTTGTAAAGGTTAAGCGGGTTCA
TTTCCGGGAATCACTATAACTCGTCTGGGT|CGAACCCTCTTCTTCTTACACATATGAAGA
CTGCCAATAGGGACAAGAAAGGTTAAGCGG|GCAGCCCCTGGTTTGCCCATTAACACCCCG
CGGGTTCAAAAAGCCTGCCACAAAGGTTAA|AAAAAGCCTGCCAAGCGGGTTCAAAAAGCC
CCAACGCTGGTAGTACTTCGACCAAGAAGA|CACCCGGCCAGTTATTAAGAAAGAAATTCC
AAGCGGGTTCAAAAAGCCTGCCACCAGTGT|AAGGTTAAGCGGGTTCAAAAAGCCTGCCAA
AAAGGTTAAGCGGGTTCAAAAAGCCTGCCA|TAGCGATTCGGGCCAAAGGTTAAGCGGGTT
CATGTTATGGGATAAGGATAAAGGTTAAGC|AGGTTAAGCGGGTTCAAAAAGCCTGCCAAA
GCAAAGGTTAAGCGGGTTCAAAAAGCCTGC|CGAGTATTTCAACCGAAAGGTTAAGCGGGT
AGTAACCACTAACCGGGAGCCTGGAATGGC|CTGCCAACGCTGGTAGTACTTCGACCAAGA
AAAGCCTGCCACAAAGGTTAAGCGGGTTCA|GCCAAGCGGGTTCAAAAAGCCTGCCAAGTA
AGATAAAGGTTAAGCGGGTTCAAAAAGCCT|CGTCACTTGTAAAGGTTAAGCGGGTTCAAA
TTAGCAATCGTCGGCATCGAACCCTCTTCT|ACCACACGATGACGATAGTTCGCGGGCATT
CTGCCATGTTATGGGATAAGGATAAAGGTT|CAAAAGGTTAAGCGGGTTCAAAAAGCCTGC
GGTTAAGCGGGTTCAAAAAGCCTGCCACAA|CGGGTTCAAAAAGCCTGCCAAGCGGGTTCA
TAAGCGGGTTCAAAAAGCCTGCCACCAGTG|AAAGGTTAAGCGGGTTCAAAAAGCCTGCCA
TTTGACGGGCGCAAGCTTCTGACATGTGGT|AAGTGAGAGCTTTGCTTTGAAAGGTTAAGC
ATAGAATGCGGCAGCGTGCGACCCAAGTTT|ACACCCTTAACTACGCCCTGCAGGGTCAAG
TGGAGGGCGGGTTGTACTTGTTGTGTGTGA|CCTATAGTCCCGAAAAAACGTCAGGATCTT
CTCTGGCCGTGGAGGGCGGGTTGTACTTGT|CAGTTAGAGCCTATAGTCCCGAAAAAACGT
GTTCAAAAAGCCTGCCATCCAGCAGCCCCT|GAACAAATGGTCACGGATGCCGGGTTATCC
CTTTGAAAGGTTAAGCGGGTTCAAAAAGCC|AGGTTAAGCGGGTTCAAAAAGCCTGCCAAG
GATAAGGATAAAGGTTAAGCGGGTTCAAAA|GGTTCAAAAAGCCTGCCAAAATAGGGGAAC
AGTACCCCCGAAGAATGCTCCGTAGCGATT|CACTAACCGGGAGCCTGGAATGGCTATCTC
CAAGTTTGACGGGCGCAAGCTTCTGACATG|GGTCAAGTGAGAGCTTTGCTTTGAAAGGTT
TATCTCTGGCCGTGGAGGGCGGGTTGTACT|AGACAGTTAGAGCCTATAGTCCCGAAAAAA
TAGGTACAGAGGGGTGACCAACAAAGGTTA|GCAACTTATATAACTCGAGTTCTGACCTAA
AAAGGTTAAGCGGGTTCAAAAAGCCTGCCA|CGGGTTCAAAAAGCCTGCCATCCAGCAGCC
AAGACAGTTAGAGCCTATAGTCCCGAAAAA|TTCCCACACTTGCTCCACGTTCTCTAGATT
TAGCGCCCCCAACGGAACAAATGGTCACGG|AAAAGCCTGCCACAAAGGTTAAGCGGGTTC
ACAAAAGGTTAAAAGGTTAAGCGGGTTCAA|AAGCGGGTTCAAAAAGCCTGCCATCCGAAT
TGGTTTGCCCATTAACACCCCGGATAGAAT|CTCATGATAACCACTTGCCGCCCACACCCT
GGCAGCGTGCGACCCAAGTTTGACGGGCGC|ACTACGCCCTGCAGGGTCAAGTGAGAGCTT
AAGCGGGTTCAAAAAGCCTGCCATCCGAAT|CAACCGAAAGGTTAAGCGGGTTCAAAAAGC
GGGACAAGAAAGGTTAAGCGGGTTCAAAAA|GGTTTGCCCATTAACACCCCGGATAGAATG
ATTTAGAGACCAAAGGTTAAGCGGGTTCAA|GGTCTTCGCGTAGCGCCCCCAACGGAACAA
CACGATGACGATAGTTCGCGGGCATTCTCG|GACCCAAGTTTGACGGGCGCAAGCTTCTGA
TTCCCCTCGTATAGCTCAGGCACTTGAGTG|CCACCTATGATTTTTCCGGGAATCACTATA
TATCCTCATGATAACCACTTGCCGCCCACA|GCCATGTTATGGGATAAGGATAAAGGTTAA
GGTTAAGCGGGTTCAAAAAGCCTGCCACCA|TGTAAAGGTTAAGCGGGTTCAAAAAGCCTG
TTCGCGGGCATTCTCGGCCGCATTTAGAGA|GGGCGCAAGCTTCTGACATGTGGTCTTCGC
TTCAAAAAGCCTGCCACTGCGCCCGATAGT|AACAAAGGTTAAGCGGGTTCAAAAAGCCTG
TCCTGTTCTTCGTAAACCACCTATGATTTT|ATATGAGATTTTTAGCAATCGTCGGCATCG
TAGTCCCGAAAAAACGTCAGGATCTTTGAC|CGTTCTCTAGATTCTTTTAACACAGATGTC
GCAGCCCCTGGTTTGCCCATTAACACCCCG|GGGTTATCCTCATGATAACCACTTGCCGCC
GCTTTGAAAGGTTAAGCGGGTTCAAAAAGC|AAGGTTAAGCGGGTTCAAAAAGCCTGCCAA
AGTTTGACGGGCGCAAGCTTCTGACATGTG|TCAAGTGAGAGCTTTGCTTTGAAAGGTTAA
AAAAGCCTGCCATCCAGCAGCCCCTGGTTT|AATGGTCACGGATGCCGGGTTATCCTCATG
CTTCCCCTCGTATAGCTCAGGCACTTGAGT|ACCACCTATGATTTTTCCGGGAATCACTAT
AAAGCCTGCCACTGCGCCCGATAGTAACCA|AGGTTAAGCGGGTTCAAAAAGCCTGCCAAC
TTTGAAAGGTTAAGCGGGTTCAAAAAGCCT|GGTTAAGCGGGTTCAAAAAGCCTGCCAAGC
AACGCTGGTAGTACTTCGACCAAGAAGACA|CCCGGCCAGTTATTAAGAAAGAAATTCCCA
GCGGGTTGTACTTGTTGTGTGTGAAGGGGA|GTCCCGAAAAAACGTCAGGATCTTTGACAA
GTTGTGTGTGAAGGGGACCTCAATAGGTAC|GTCAGGATCTTTGACAAAAGCCCGCAACTT
ATTTTTCCGGGAATCACTATAACTCGTCTG|CATCGAACCCTCTTCTTCTTACACATATGA
AATCTTACATGGGTGTTGATTTAGTAAGTA|AGCCTGCCACTGCGCCCGATAGTAACCACT
TAAGCGGGTTCAAAAAGCCTGCCACCACAC|CACCCCGGATAGAATGCGGCAGCGTGCGAC
GGGTCAAGTGAGAGCTTTGCTTTGAAAGGT|CACACTACAAAAGGTTAAAAGGTTAAGCGG
GCCAATAGGGACAAGAAAGGTTAAGCGGGT|AGCCCCTGGTTTGCCCATTAACACCCCGGA
CCACCAGTGTATCAAGCATGTCGGGTCCCG|AGCCTGCCAATAGGGACAAGAAAGGTTAAG
CTGCCATCCGAATCTTACATGGGTGTTGAT|GGGTTCAAAAAGCCTGCCACTGCGCCCGAT
AAGTTTGACGGGCGCAAGCTTCTGACATGT|GTCAAGTGAGAGCTTTGCTTTGAAAGGTTA
CTTGCCGCCCACACCCTTAACTACGCCCTG|GGATAAAGGTTAAGCGGGTTCAAAAAGCCT
TAAGCGGGTTCAAAAAGCCTGCCACAAAGG|GTTCAAAAAGCCTGCCAAGCGGGTTCAAAA
TTAGAGACCAAAGGTTAAGCGGGTTCAAAA|TCTTCGCGTAGCGCCCCCAACGGAACAAAT
TCTGGCCGTGGAGGGCGGGTTGTACTTGTT|AGTTAGAGCCTATAGTCCCGAAAAAACGTC
GGAACCTTCGCAAAGGTTAAGCGGGTTCAA|CCTGCCAGCCGAGTATTTCAACCGAAAGGT
TTAAGCGGGTTCAAAAAGCCTGCCACACTA|GCCAAAATAGGGGAACCTTCGCAAAGGTTA
GGTTCAAAAAGCCTGCCACTGCGCCCGATA|CCAACAAAGGTTAAGCGGGTTCAAAAAGCC
CCTCATGATAACCACTTGCCGCCCACACCC|ATGTTATGGGATAAGGATAAAGGTTAAGCG
GGAATCACTATAACTCGTCTGGGTTGTAGA|CTCTTCTTCTTACACATATGAAGATGCCGT
CGTGCGACCCAAGTTTGACGGGCGCAAGCT|GCCCTGCAGGGTCAAGTGAGAGCTTTGCTT
AAAAAGCCTGCCAACGCTGGTAGTACTTCG|TTCCTCTCTCCACCCGGCCAGTTATTAAGA
GGTCCCGTAGAAAACATATGAGATTTTTAG|GGTTAAGCGGGTTCAAAAAGCCTGCCACCA
CAAAAAGCCTGCCAATCGAGGGATATTTCG|GTTCAAAAAGCCTGCCACCAGTGTATCAAG
AAGGTTAAGCGGGTTCAAAAAGCCTGCCAA|GGGTTCAAAAAGCCTGCCATCCAGCAGCCC
CGAAGAATGCTCCGTAGCGATTCGGGCCAA|GGGAGCCTGGAATGGCTATCTCTGGCCGTG
AGCGTGCGACCCAAGTTTGACGGGCGCAAG|ACGCCCTGCAGGGTCAAGTGAGAGCTTTGC
GCGCCCCCAACGGAACAAATGGTCACGGAT|AAGCCTGCCACAAAGGTTAAGCGGGTTCAA
AAGCCTGCCATGTTATGGGATAAGGATAAA|ATGACAAAAGGTTAAGCGGGTTCAAAAAGC
ACTAACCGGGAGCCTGGAATGGCTATCTCT|CGCTGGTAGTACTTCGACCAAGAAGACAGT
AGCCTGCCACTGCGCCCGATAGTAACCACT|GTTAAGCGGGTTCAAAAAGCCTGCCAACGC
AAACGTCAGGATCTTTGACAAAAGCCCGCA|TTCTTTTAACACAGATGTCCTCAATGAGAC
TCTTCGTAAACCACCTATGATTTTTCCGGG|GATTTTTAGCAATCGTCGGCATCGAACCCT
GAAAGGTTAAGCGGGTTCAAAAAGCCTGCC|TAAGCGGGTTCAAAAAGCCTGCCAAGCGGG
TTAACTACGCCCTGCAGGGTCAAGTGAGAG|GGTTCAAAAAGCCTGCCACACTACAAAAGG
TATCAAGCATGTCGGGTCCCGTAGAAAACA|ATAGGGACAAGAAAGGTTAAGCGGGTTCAA
ATATGAAGATGCCGTCACTTGTAAAGGTTA|CATTTAGAGACCAAAGGTTAAGCGGGTTCA
AAAAAGCCTGCCAAGTACGATGACAAAAGG|GTAAGTACCCCCGAAGAATGCTCCGTAGCG
CAAATGGTCACGGATGCCGGGTTATCCTCA|GTTAAGCGGGTTCAAAAAGCCTGCCATGTT
GAATCTTACATGGGTGTTGATTTAGTAAGT|AAGCCTGCCACTGCGCCCGATAGTAACCAC
AGAATGCTCCGTAGCGATTCGGGCCAAAGG|AGCCTGGAATGGCTATCTCTGGCCGTGGAG
CCCCAACGGAACAAATGGTCACGGATGCCG|CTGCCACAAAGGTTAAGCGGGTTCAAAAAG
CGCCCCCAACGGAACAAATGGTCACGGATG|AGCCTGCCACAAAGGTTAAGCGGGTTCAAA
ATGGGTGTTGATTTAGTAAGTACCCCCGAA|ACTGCGCCCGATAGTAACCACTAACCGGGA
AAAGGTTAAGCGGGTTCAAAAAGCCTGCCA|AAAAGCCTGCCATCCGAATCTTACATGGGT
TCATGATAACCACTTGCCGCCCACACCCTT|GTTATGGGATAAGGATAAAGGTTAAGCGGG
GCGGGTTCAAAAAGCCTGCCAACGCTGGTA|CACTGATCTTCCTCTCTCCACCCGGCCAGT
CGGGTTATCCTCATGATAACCACTTGCCGC|AGCCTGCCATGTTATGGGATAAGGATAAAG
GATAGAATGCGGCAGCGTGCGACCCAAGTT|CACACCCTTAACTACGCCCTGCAGGGTCAA
GAAAACATATGAGATTTTTAGCAATCGTCG|GGTTCAAAAAGCCTGCCACCACACGATGAC
TGCCACAAAGGTTAAGCGGGTTCAAAAAGC|CGGGTTCAAAAAGCCTGCCAAGTACGATGA
AAGCATGTCGGGTCCCGTAGAAAACATATG|GGACAAGAAAGGTTAAGCGGGTTCAAAAAG
GAAAGGTTAAGCGGGTTCAAAAAGCCTGCC|CCATTAACACCCCGGATAGAATGCGGCAGC
AGCGGGTTCAAAAAGCCTGCCAAGCGGGTT|GCCATCCGAATCTTACATGGGTGTTGATTT
TGTGTGAAGGGGACCTCAATAGGTACAGAG|GGATCTTTGACAAAAGCCCGCAACTTATAT
CCGGGAATCACTATAACTCGTCTGGGTTGT|ACCCTCTTCTTCTTACACATATGAAGATGC
GTACTTGTTGTGTGTGAAGGGGACCTCAAT|AAAAACGTCAGGATCTTTGACAAAAGCCCG
AAAAGCCTGCCACCACACGATGACGATAGT|AATGCGGCAGCGTGCGACCCAAGTTTGACG
AGGGATATTTCGTCCTTGGCACCTAGATTA|CAGTGTATCAAGCATGTCGGGTCCCGTAGA
GCGGGTTCAAAAAGCCTGCCATCCGAATCT|ACCGAAAGGTTAAGCGGGTTCAAAAAGCCT
CGGGTTCAAAAAGCCTGCCACCACACGATG|CCGGATAGAATGCGGCAGCGTGCGACCCAA
AGAGGGGTGACCAACAAAGGTTAAGCGGGT|ATATAACTCGAGTTCTGACCTAAGCACTGA
AGCGGGTTCAAAAAGCCTGCCACTGCGCCC|GTGACCAACAAAGGTTAAGCGGGTTCAAAA
TTGACGGGCGCAAGCTTCTGACATGTGGTC|AGTGAGAGCTTTGCTTTGAAAGGTTAAGCG
TTGTTGTGTGTGAAGGGGACCTCAATAGGT|ACGTCAGGATCTTTGACAAAAGCCCGCAAC
TAAGTACCCCCGAAGAATGCTCCGTAGCGA|ACCACTAACCGGGAGCCTGGAATGGCTATC
GATGCCGGGTTATCCTCATGATAACCACTT|CAAAAAGCCTGCCATGTTATGGGATAAGGA
CACTTGAGTGTATTCGTGGAAACCGAAAAG|AATCACTATAACTCGTCTGGGTTGTAGATA
CTCGTATAGCTCAGGCACTTGAGTGTATTC|TATGATTTTTCCGGGAATCACTATAACTCG
TTAACACCCCGGATAGAATGCGGCAGCGTG|CACTTGCCGCCCACACCCTTAACTACGCCC
CAAAGGTTAAGCGGGTTCAAAAAGCCTGCC|TAGCGCCCCCAACGGAACAAATGGTCACGG
CTATAGTCCCGAAAAAACGTCAGGATCTTT|CCACGTTCTCTAGATTCTTTTAACACAGAT
GCCTGCCAATAGGGACAAGAAAGGTTAAGC|CAGCAGCCCCTGGTTTGCCCATTAACACCC
AGCGGGTTCAAAAAGCCTGCCAACGCTGGT|GCACTGATCTTCCTCTCTCCACCCGGCCAG
AGCGGGTTCAAAAAGCCTGCCACCACACGA|CCCCGGATAGAATGCGGCAGCGTGCGACCC
CATCCGAATCTTACATGGGTGTTGATTTAG|TCAAAAAGCCTGCCACTGCGCCCGATAGTA
TTCGCAAAGGTTAAGCGGGTTCAAAAAGCC|AGCCGAGTATTTCAACCGAAAGGTTAAGCG
TTCAAAAAGCCTGCCACCACACGATGACGA|ATAGAATGCGGCAGCGTGCGACCCAAGTTT
ACGATGACAAAAGGTTAAGCGGGTTCAAAA|AATGCTCCGTAGCGATTCGGGCCAAAGGTT
TAAGCGGGTTCAAAAAGCCTGCCACACTAC|CCAAAATAGGGGAACCTTCGCAAAGGTTAA
TAAGCGGGTTCAAAAAGCCTGCCATGTTAT|GCCTGCCAAGTACGATGACAAAAGGTTAAG
GGTTAAGCGGGTTCAAAAAGCCTGCCATCC|ATTTCAACCGAAAGGTTAAGCGGGTTCAAA
CACGGATGCCGGGTTATCCTCATGATAACC|GGTTCAAAAAGCCTGCCATGTTATGGGATA
AACCACTAACCGGGAGCCTGGAATGGCTAT|CCAACGCTGGTAGTACTTCGACCAAGAAGA
ACCCTCTTCTTCTTACACATATGAAGATGC|CGCGGGCATTCTCGGCCGCATTTAGAGACC
GTACTTCGACCAAGAAGACAGTTAGAGCCT|TATTAAGAAAGAAATTCCCACACTTGCTCC
CCCATTAACACCCCGGATAGAATGCGGCAG|TAACCACTTGCCGCCCACACCCTTAACTAC
AAAGCCTGCCACACTACAAAAGGTTAAAAG|ACCTTCGCAAAGGTTAAGCGGGTTCAAAAA
TTAGTAAGTACCCCCGAAGAATGCTCCGTA|AGTAACCACTAACCGGGAGCCTGGAATGGC
GTTTGACGGGCGCAAGCTTCTGACATGTGG|CAAGTGAGAGCTTTGCTTTGAAAGGTTAAG
GATTATACCTCCTGTTCTTCGTAAACCACC|GTAGAAAACATATGAGATTTTTAGCAATCG
CGCTGGTAGTACTTCGACCAAGAAGACAGT|CGGCCAGTTATTAAGAAAGAAATTCCCACA
AGGCACTTGAGTGTATTCGTGGAAACCGAA|GGGAATCACTATAACTCGTCTGGGTTGTAG
AAAGCCTGCCACCACACGATGACGATAGTT|ATGCGGCAGCGTGCGACCCAAGTTTGACGG
CTTCTGACATGTGGTCTTCGCGTAGCGCCC|TTTGAAAGGTTAAGCGGGTTCAAAAAGCCT
CCCTGCAGGGTCAAGTGAGAGCTTTGCTTT|AGCCTGCCACACTACAAAAGGTTAAAAGGT
AGCCTGCCAATCGAGGGATATTTCGTCCTT|AAAAGCCTGCCACCAGTGTATCAAGCATGT
CCGATAGTAACCACTAACCGGGAGCCTGGA|AAAGCCTGCCAACGCTGGTAGTACTTCGAC
CTTCTTACACATATGAAGATGCCGTCACTT|TTCTCGGCCGCATTTAGAGACCAAAGGTTA
ATAAGGATAAAGGTTAAGCGGGTTCAAAAA|GTTCAAAAAGCCTGCCAAAATAGGGGAACC
GCAGGGTCAAGTGAGAGCTTTGCTTTGAAA|TGCCACACTACAAAAGGTTAAAAGGTTAAG
TAGGGACAAGAAAGGTTAAGCGGGTTCAAA|CTGGTTTGCCCATTAACACCCCGGATAGAA
CCAATAGGGACAAGAAAGGTTAAGCGGGTT|GCCCCTGGTTTGCCCATTAACACCCCGGAT
TCGAACCCTCTTCTTCTTACACATATGAAG|AGTTCGCGGGCATTCTCGGCCGCATTTAGA
AACCACTTGCCGCCCACACCCTTAACTACG|GATAAGGATAAAGGTTAAGCGGGTTCAAAA
AAAACATATGAGATTTTTAGCAATCGTCGG|GTTCAAAAAGCCTGCCACCACACGATGACG
AAGGTTAAGCGGGTTCAAAAAGCCTGCCAC|ATTAACACCCCGGATAGAATGCGGCAGCGT
AAAGCCTGCCAAGTACGATGACAAAAGGTT|AAGTACCCCCGAAGAATGCTCCGTAGCGAT
AAAGGTTAAGCGGGTTCAAAAAGCCTGCCA|TGACCTAAGCACTGATCTTCCTCTCTCCAC
CGGGAGCCTGGAATGGCTATCTCTGGCCGT|TAGTACTTCGACCAAGAAGACAGTTAGAGC
GTTCAAAAAGCCTGCCACCACACGATGACG|GATAGAATGCGGCAGCGTGCGACCCAAGTT
CCACTTGCCGCCCACACCCTTAACTACGCC|TAAGGATAAAGGTTAAGCGGGTTCAAAAAG
GGACCTCAATAGGTACAGAGGGGTGACCAA|CAAAAGCCCGCAACTTATATAACTCGAGTT
TGTTGTGTGTGAAGGGGACCTCAATAGGTA|CGTCAGGATCTTTGACAAAAGCCCGCAACT
CTCAGGCACTTGAGTGTATTCGTGGAAACC|TCCGGGAATCACTATAACTCGTCTGGGTTG
CCCGAAAAAACGTCAGGATCTTTGACAAAA|CTCTAGATTCTTTTAACACAGATGTCCTCA
GCGACCCAAGTTTGACGGGCGCAAGCTTCT|CTGCAGGGTCAAGTGAGAGCTTTGCTTTGA
CTGCCACTGCGCCCGATAGTAACCACTAAC|AAGCGGGTTCAAAAAGCCTGCCAACGCTGG
CTCGGCCGCATTTAGAGACCAAAGGTTAAG|CTGACATGTGGTCTTCGCGTAGCGCCCCCA
GCGTAGCGCCCCCAACGGAACAAATGGTCA|TCAAAAAGCCTGCCACAAAGGTTAAGCGGG
TTCAAAAAGCCTGCCAAGCGGGTTCAAAAA|CGAATCTTACATGGGTGTTGATTTAGTAAG
TTAAGCGGGTTCAAAAAGCCTGCCACAAAG|GGTTCAAAAAGCCTGCCAAGCGGGTTCAAA
GAGCCTGGAATGGCTATCTCTGGCCGTGGA|TACTTCGACCAAGAAGACAGTTAGAGCCTA
CGAATCTTACATGGGTGTTGATTTAGTAAG|AAAGCCTGCCACTGCGCCCGATAGTAACCA
GCCAAGCGGGTTCAAAAAGCCTGCCAAGTA|GGGTGTTGATTTAGTAAGTACCCCCGAAGA
AGCCTGCCAGCCGAGTATTTCAACCGAAAG|TGTGTGTGAAGGGGACCTCAATAGGTACAG
GGTACAGAGGGGTGACCAACAAAGGTTAAG|AACTTATATAACTCGAGTTCTGACCTAAGC
GGTTCAAAAAGCCTGCCATCCAGCAGCCCC|GGAACAAATGGTCACGGATGCCGGGTTATC
AGGTTAAGCGGGTTCAAAAAGCCTGCCATC|TATTTCAACCGAAAGGTTAAGCGGGTTCAA
GAAGAATGCTCCGTAGCGATTCGGGCCAAA|GGAGCCTGGAATGGCTATCTCTGGCCGTGG
CCGCCCACACCCTTAACTACGCCCTGCAGG|AAAGGTTAAGCGGGTTCAAAAAGCCTGCCA
CTGTTCTTCGTAAACCACCTATGATTTTTC|ATGAGATTTTTAGCAATCGTCGGCATCGAA
GGCCGCATTTAGAGACCAAAGGTTAAGCGG|ACATGTGGTCTTCGCGTAGCGCCCCCAACG
ACCTCCTGTTCTTCGTAAACCACCTATGAT|AACATATGAGATTTTTAGCAATCGTCGGCA
ATTTAGTAAGTACCCCCGAAGAATGCTCCG|ATAGTAACCACTAACCGGGAGCCTGGAATG
GGATAGAATGCGGCAGCGTGCGACCCAAGT|CCACACCCTTAACTACGCCCTGCAGGGTCA
GTTAAGCGGGTTCAAAAAGCCTGCCACCAC|AACACCCCGGATAGAATGCGGCAGCGTGCG
GAATCACTATAACTCGTCTGGGTTGTAGAT|TCTTCTTCTTACACATATGAAGATGCCGTC
TACACATATGAAGATGCCGTCACTTGTAAA|GGCCGCATTTAGAGACCAAAGGTTAAGCGG
TCAAGCATGTCGGGTCCCGTAGAAAACATA|AGGGACAAGAAAGGTTAAGCGGGTTCAAAA
CGGGTTCAAAAAGCCTGCCAGCCGAGTATT|GTTGTACTTGTTGTGTGTGAAGGGGACCTC
CGAAAGGTTAAGCGGGTTCAAAAAGCCTGC|GTACAGAGGGGTGACCAACAAAGGTTAAGC
AAAAGGTTAAGCGGGTTCAAAAAGCCTGCC|AGATAAAGGTTAAGCGGGTTCAAAAAGCCT
GTTCAAAAAGCCTGCCACACTACAAAAGGT|AGGGGAACCTTCGCAAAGGTTAAGCGGGTT
ACGGGCGCAAGCTTCTGACATGTGGTCTTC|GAGAGCTTTGCTTTGAAAGGTTAAGCGGGT
CCAAAGGTTAAGCGGGTTCAAAAAGCCTGC|GTAGCGCCCCCAACGGAACAAATGGTCACG
TGATTTTTCCGGGAATCACTATAACTCGTC|GGCATCGAACCCTCTTCTTCTTACACATAT
TTCTTCGTAAACCACCTATGATTTTTCCGG|AGATTTTTAGCAATCGTCGGCATCGAACCC
GAGGGCGGGTTGTACTTGTTGTGTGTGAAG|TATAGTCCCGAAAAAACGTCAGGATCTTTG
GAGCCTATAGTCCCGAAAAAACGTCAGGAT|TGCTCCACGTTCTCTAGATTCTTTTAACAC
TTTAGAGACCAAAGGTTAAGCGGGTTCAAA|GTCTTCGCGTAGCGCCCCCAACGGAACAAA
AATGCGGCAGCGTGCGACCCAAGTTTGACG|CCTTAACTACGCCCTGCAGGGTCAAGTGAG
TGCCATCCGAATCTTACATGGGTGTTGATT|GGTTCAAAAAGCCTGCCACTGCGCCCGATA
ATGCCGGGTTATCCTCATGATAACCACTTG|AAAAAGCCTGCCATGTTATGGGATAAGGAT
TTTAGCAATCGTCGGCATCGAACCCTCTTC|CACCACACGATGACGATAGTTCGCGGGCAT
TTCAACCGAAAGGTTAAGCGGGTTCAAAAA|CAATAGGTACAGAGGGGTGACCAACAAAGG
CGGGCCAAAGGTTAAGCGGGTTCAAAAAGC|TGGCCGTGGAGGGCGGGTTGTACTTGTTGT
AGAAGACAGTTAGAGCCTATAGTCCCGAAA|AATTCCCACACTTGCTCCACGTTCTCTAGA
ATCGAGGGATATTTCGTCCTTGGCACCTAG|CCACCAGTGTATCAAGCATGTCGGGTCCCG
TGCGCCCGATAGTAACCACTAACCGGGAGC|TTCAAAAAGCCTGCCAACGCTGGTAGTACT
AACCCTCTTCTTCTTACACATATGAAGATG|TCGCGGGCATTCTCGGCCGCATTTAGAGAC
ATGTGGTCTTCGCGTAGCGCCCCCAACGGA|GTTAAGCGGGTTCAAAAAGCCTGCCACAAA
GGCGCAAGCTTCTGACATGTGGTCTTCGCG|AGCTTTGCTTTGAAAGGTTAAGCGGGTTCA
AGCATGTCGGGTCCCGTAGAAAACATATGA|GACAAGAAAGGTTAAGCGGGTTCAAAAAGC
GGGCGCAAGCTTCTGACATGTGGTCTTCGC|GAGCTTTGCTTTGAAAGGTTAAGCGGGTTC
CTGCCACAAAGGTTAAGCGGGTTCAAAAAG|GCGGGTTCAAAAAGCCTGCCAAGTACGATG
CGGGTTCAAAAAGCCTGCCAAGTACGATGA|TGATTTAGTAAGTACCCCCGAAGAATGCTC
CCACACCCTTAACTACGCCCTGCAGGGTCA|GTTAAGCGGGTTCAAAAAGCCTGCCACACT
GTAAGTACCCCCGAAGAATGCTCCGTAGCG|AACCACTAACCGGGAGCCTGGAATGGCTAT
AGTAAGTACCCCCGAAGAATGCTCCGTAGC|TAACCACTAACCGGGAGCCTGGAATGGCTA
GGTTCAAAAAGCCTGCCAAGCGGGTTCAAA|TCCGAATCTTACATGGGTGTTGATTTAGTA
CTTCTTCTTACACATATGAAGATGCCGTCA|GCATTCTCGGCCGCATTTAGAGACCAAAGG
TTGAGTGTATTCGTGGAAACCGAAAAGGTT|CACTATAACTCGTCTGGGTTGTAGATAAAG
AAAAGCCTGCCAAGTACGATGACAAAAGGT|TAAGTACCCCCGAAGAATGCTCCGTAGCGA
TGTCTTCCCCTCGTATAGCTCAGGCACTTG|TAAACCACCTATGATTTTTCCGGGAATCAC
TTCAAAAAGCCTGCCACACTACAAAAGGTT|GGGGAACCTTCGCAAAGGTTAAGCGGGTTC
CAAAAAGCCTGCCACACTACAAAAGGTTAA|GGAACCTTCGCAAAGGTTAAGCGGGTTCAA
TTCAAAAAGCCTGCCATCCGAATCTTACAT|AAGGTTAAGCGGGTTCAAAAAGCCTGCCAC
CCTAGATTATACCTCCTGTTCTTCGTAAAC|TCCCGTAGAAAACATATGAGATTTTTAGCA
TTCAAAAAGCCTGCCAACGCTGGTAGTACT|ATCTTCCTCTCTCCACCCGGCCAGTTATTA
AAACCGAAAAGGTTAAGCGGGTTCAAAAAG|GGTTGTAGATAAAGGTTAAGCGGGTTCAAA
TACATGGGTGTTGATTTAGTAAGTACCCCC|GCCACTGCGCCCGATAGTAACCACTAACCG
AGGTTAAGCGGGTTCAAAAAGCCTGCCATG|AAAAGCCTGCCAAGTACGATGACAAAAGGT
ACAAAGGTTAAGCGGGTTCAAAAAGCCTGC|TCTGACCTAAGCACTGATCTTCCTCTCTCC
AGGTTAAGCGGGTTCAAAAAGCCTGCCACT|AGAGGGGTGACCAACAAAGGTTAAGCGGGT
CGGGTTCAAAAAGCCTGCCACCAGTGTATC|GTTAAGCGGGTTCAAAAAGCCTGCCAATAG
TCTCTGGCCGTGGAGGGCGGGTTGTACTTG|ACAGTTAGAGCCTATAGTCCCGAAAAAACG
CCCGAAGAATGCTCCGTAGCGATTCGGGCC|CCGGGAGCCTGGAATGGCTATCTCTGGCCG
GGCGGGTTGTACTTGTTGTGTGTGAAGGGG|AGTCCCGAAAAAACGTCAGGATCTTTGACA
AGTGTATCAAGCATGTCGGGTCCCGTAGAA|GCCAATAGGGACAAGAAAGGTTAAGCGGGT
AAAATAGGGGAACCTTCGCAAAGGTTAAGC|TCAAAAAGCCTGCCAGCCGAGTATTTCAAC
TAAACCACCTATGATTTTTCCGGGAATCAC|TAGCAATCGTCGGCATCGAACCCTCTTCTT
CTTAACTACGCCCTGCAGGGTCAAGTGAGA|GGGTTCAAAAAGCCTGCCACACTACAAAAG
CAGCCGAGTATTTCAACCGAAAGGTTAAGC|GAAGGGGACCTCAATAGGTACAGAGGGGTG
ACACGATGACGATAGTTCGCGGGCATTCTC|CGACCCAAGTTTGACGGGCGCAAGCTTCTG
TGTTATGGGATAAGGATAAAGGTTAAGCGG|GTTAAGCGGGTTCAAAAAGCCTGCCAAAAT
AGGTGTCTTCCCCTCGTATAGCTCAGGCAC|TCGTAAACCACCTATGATTTTTCCGGGAAT
TTCCGGGAATCACTATAACTCGTCTGGGTT|GAACCCTCTTCTTCTTACACATATGAAGAT
GTGCGACCCAAGTTTGACGGGCGCAAGCTT|CCCTGCAGGGTCAAGTGAGAGCTTTGCTTT
GTTCAAAAAGCCTGCCAAGCGGGTTCAAAA|CCGAATCTTACATGGGTGTTGATTTAGTAA
CGGGTTCAAAAAGCCTGCCACACTACAAAA|AATAGGGGAACCTTCGCAAAGGTTAAGCGG
AATGGTCACGGATGCCGGGTTATCCTCATG|TAAGCGGGTTCAAAAAGCCTGCCATGTTAT
TGTGTGTGAAGGGGACCTCAATAGGTACAG|CAGGATCTTTGACAAAAGCCCGCAACTTAT
TGGTAGTACTTCGACCAAGAAGACAGTTAG|CCAGTTATTAAGAAAGAAATTCCCACACTT
GGTTAAGCGGGTTCAAAAAGCCTGCCACAC|CTGCCAAAATAGGGGAACCTTCGCAAAGGT
TCAGGCACTTGAGTGTATTCGTGGAAACCG|CCGGGAATCACTATAACTCGTCTGGGTTGT
AGGTACAGAGGGGTGACCAACAAAGGTTAA|CAACTTATATAACTCGAGTTCTGACCTAAG
TCGTATAGCTCAGGCACTTGAGTGTATTCG|ATGATTTTTCCGGGAATCACTATAACTCGT
CGCCCGATAGTAACCACTAACCGGGAGCCT|CAAAAAGCCTGCCAACGCTGGTAGTACTTC
GGTGACCAACAAAGGTTAAGCGGGTTCAAA|ACTCGAGTTCTGACCTAAGCACTGATCTTC
GCGGCAGCGTGCGACCCAAGTTTGACGGGC|TAACTACGCCCTGCAGGGTCAAGTGAGAGC
CTTACACATATGAAGATGCCGTCACTTGTA|TCGGCCGCATTTAGAGACCAAAGGTTAAGC
CCAAGAAGACAGTTAGAGCCTATAGTCCCG|AGAAATTCCCACACTTGCTCCACGTTCTCT
TGACGATAGTTCGCGGGCATTCTCGGCCGC|AAGTTTGACGGGCGCAAGCTTCTGACATGT
CGTAGAAAACATATGAGATTTTTAGCAATC|AGCGGGTTCAAAAAGCCTGCCACCACACGA
CCAAGTACGATGACAAAAGGTTAAGCGGGT|CCGAAGAATGCTCCGTAGCGATTCGGGCCA
GCGGGCATTCTCGGCCGCATTTAGAGACCA|CGCAAGCTTCTGACATGTGGTCTTCGCGTA